Tournament,Date,Team_1,Team_2,Score_1,Score_2,Game_Rank_Diff_USAU,Game_Wght_USAU,Is_Ignored_USAU,Team_Rank_Diff_USAU,Game_Rank_Diff_Windmill,Game_Wght_Windmill,Is_Ignored_Windmill,Team_Rank_Diff_Windmill,Game_Rank_Diff_Sigmoid,Game_Wght_Sigmoid,Is_Ignored_Sigmoid,Team_Rank_Diff_Sigmoid
Mixed Imperial,2023-03-25,BN1,Oxford Ultimate,9,8,125.0,0.9459053029269173,0,-66.99999999999999,1,1,0,-0.8200000000000001,1,1,0,-0.7688256813451702
Mixed Imperial,2023-03-25,Brixton,Plymouth Ultimate,6,1,600.0,0.6488856845230502,0,63.60000000000002,5,1,0,1.0600000000000005,5,1,0,1.0288818412993344
Mixed Imperial,2023-03-25,Cambridge Ultimate,Brixton,11,6,546.6949863040446,0.9459053029269173,0,836.9599999999999,5,1,0,10.25,5,1,0,10.35231185317205
Mixed Imperial,2023-03-25,Cambridge Ultimate,Plymouth Ultimate,14,1,600.0,1.0,1,900.56,13,1,0,11.31,13,1,0,10.866770179157953
Mixed Imperial,2023-03-25,Curve,Guildford,6,3,546.6949863040446,0.6882472016116853,0,96.14999999999998,3,1,0,1.0199999999999996,3,1,0,1.0221633923134235
Mixed Imperial,2023-03-25,Curve,Sharkbear!,11,1,600.0,0.9176629354822471,0,532.8499999999999,10,1,0,5.409999999999998,10,1,0,5.909033105265994
Mixed Imperial,2023-03-25,Curve,Zoo 1,7,3,600.0,0.7254762501100116,0,-221.77999999999997,4,1,0,-3.2300000000000004,4,1,0,-3.7343467345718437
Mixed Imperial,2023-03-25,Deep Space,GB U24 Mixed,11,6,546.6949863040446,0.9459053029269173,0,268.9200000000001,5,1,0,2.13,5,1,0,3.374764362167557
Mixed Imperial,2023-03-25,Deep Space,Thundering Herd,8,4,564.8086448756737,0.7947194142390263,0,722.6300000000001,4,1,0,8.28,4,1,0,9.171431549913159
Mixed Imperial,2023-03-25,GB U24 Mixed,Thundering Herd,10,8,262.66557693448596,0.9733285267845752,0,453.71,2,1,0,6.15,2,1,0,6.721255675046002
Mixed Imperial,2023-03-25,Guildford,Sharkbear!,6,4,365.60925011032475,0.7254762501100116,0,436.69999999999993,2,1,0,4.389999999999999,2,1,0,5.021673693721176
Mixed Imperial,2023-03-25,Hooves,Deep Space,13,7,557.5316737222639,1.0,0,254.9899999999999,6,1,0,2.3899999999999997,6,1,0,2.6508739329519067
Mixed Imperial,2023-03-25,Hooves,GB U24 Mixed,12,6,579.3107485100336,0.9733285267845752,0,523.91,6,1,0,4.52,6,1,0,5.795218479778505
Mixed Imperial,2023-03-25,Hooves,Thundering Herd,10,4,600.0,0.8583950752789521,0,977.6199999999999,6,1,0,10.67,6,1,0,10.669424009576705
Mixed Imperial,2023-03-25,Lemmings 1,BN1,10,9,125.0,1.0,0,501.28,1,1,0,5.5600000000000005,1,1,0,6.544479072651949
Mixed Imperial,2023-03-25,Lemmings 1,Oxford Ultimate,13,10,328.14240231865136,1.0,0,434.28000000000003,3,1,0,4.74,3,1,0,5.907765833162795
Mixed Imperial,2023-03-25,Mixed Feelings,Curve,8,3,600.0,0.7608859102526822,0,488.06,5,1,0,6.4,5,1,0,7.386300519683012
Mixed Imperial,2023-03-25,Mixed Feelings,Guildford,10,1,600.0,0.8583950752789521,0,584.21,9,1,0,7.42,9,1,0,8.135473366674503
Mixed Imperial,2023-03-25,Mixed Feelings,Sharkbear!,13,1,600.0,1.0,1,1020.9099999999999,12,1,0,11.809999999999999,12,1,0,11.135290466470678
Mixed Imperial,2023-03-25,Mixed Feelings,Zoo 1,9,3,600.0,0.8271701918685112,0,266.28000000000003,6,1,0,3.17,6,1,0,4.162203010516368
Mixed Imperial,2023-03-25,Purple Cobras,Brixton,11,4,600.0,0.9176629354822471,0,477.96999999999997,7,1,0,6.07,7,1,0,6.86196726224221
Mixed Imperial,2023-03-25,Purple Cobras,Cambridge Ultimate,8,3,600.0,0.7608859102526822,0,-358.99,5,1,0,-4.18,5,1,0,-5.100762395888713
Mixed Imperial,2023-03-25,Purple Cobras,Plymouth Ultimate,13,4,600.0,1.0,0,541.5699999999999,9,1,0,7.130000000000001,9,1,0,7.650779426926668
Mixed Imperial,2023-03-25,Reading,BN1,13,9,418.5661446562001,1.0,0,716.5899999999999,4,1,0,7.94,4,1,0,9.133770350656317
Mixed Imperial,2023-03-25,Reading,Lemmings 1,12,7,520.5112660164395,1.0,0,215.30999999999995,5,1,0,2.3800000000000003,5,1,0,3.526059910962612
Mixed Imperial,2023-03-25,Reading,Oxford Ultimate,13,9,418.5661446562001,1.0,0,649.5899999999999,4,1,0,7.12,4,1,0,8.634426153882476
Mixed Imperial,2023-03-25,Zoo 1,Guildford,7,2,600.0,0.7254762501100116,0,317.92999999999995,5,1,0,4.25,5,1,0,4.6771623272986105
Mixed Imperial,2023-03-25,Zoo 1,Sharkbear!,6,3,546.6949863040446,0.6882472016116853,0,754.6299999999999,3,1,0,8.639999999999999,3,1,0,8.782095230044657
Mixed Imperial,2023-03-26,BN1,Curve,15,4,600.0,1.0,1,729.96,11,1,0,9.510000000000002,11,1,0,9.843764344031282
Mixed Imperial,2023-03-26,BN1,Thundering Herd,10,5,573.8977938505714,0.8885233166386386,0,31.27000000000001,5,1,0,0.3599999999999999,5,1,0,0.4985662814788707
Mixed Imperial,2023-03-26,Brixton,Guildford,5,3,418.5661446562001,0.6488856845230502,0,126.5,2,1,0,1.58,2,1,0,1.7211363721971793
Mixed Imperial,2023-03-26,Brixton,Sharkbear!,12,2,600.0,0.9459053029269173,0,563.1999999999999,10,1,0,5.969999999999999,10,1,0,6.4933781908754575
Mixed Imperial,2023-03-26,Brixton,Zoo 1,5,3,418.5661446562001,0.6488856845230502,0,-191.42999999999995,2,1,0,-2.67,2,1,0,-3.0657107386296083
Mixed Imperial,2023-03-26,Cambridge Ultimate,Mixed Feelings,15,10,453.6039151898044,1.0,0,379.25,5,1,0,4.41,5,1,0,5.125288079781999
Mixed Imperial,2023-03-26,Cambridge Ultimate,Purple Cobras,10,7,389.6652919127421,0.9459053029269173,0,358.99,3,1,0,4.18,3,1,0,5.100762395888715
Mixed Imperial,2023-03-26,Deep Space,Reading,15,13,214.17926913507503,1.0,0,-25.229999999999905,2,1,0,-0.020000000000000462,2,1,0,-0.4386249167908023
Mixed Imperial,2023-03-26,GB U24 Mixed,BN1,11,8,365.60925011032475,1.0,0,422.43999999999994,3,1,0,5.79,3,1,0,6.316766868050472
Mixed Imperial,2023-03-26,GB U24 Mixed,Cambridge Ultimate,14,5,600.0,1.0,0,285.09,9,1,0,4.49,9,1,0,4.912160922130582
Mixed Imperial,2023-03-26,GB U24 Mixed,Oxford Ultimate,15,4,600.0,1.0,0,355.44,11,1,0,4.97,11,1,0,5.670331965279438
Mixed Imperial,2023-03-26,Guildford,Plymouth Ultimate,8,4,564.8086448756737,0.7947194142390263,0,-62.89999999999998,4,1,0,-0.5199999999999996,4,1,0,-0.6977460902079748
Mixed Imperial,2023-03-26,Guildford,Sharkbear!,8,1,600.0,0.7608859102526822,0,436.69999999999993,7,1,0,4.389999999999999,7,1,0,5.021673693721176
Mixed Imperial,2023-03-26,Guildford,Zoo 1,8,7,125.0,0.8885233166386386,0,-317.92999999999995,1,1,0,-4.25,1,1,0,-4.677162327298612
Mixed Imperial,2023-03-26,Hooves,Deep Space,15,13,214.17926913507503,1.0,0,254.9899999999999,2,1,0,2.3899999999999997,2,1,0,2.6508739329519067
Mixed Imperial,2023-03-26,Hooves,Lemmings 1,15,10,453.6039151898044,1.0,0,445.06999999999994,5,1,0,4.75,5,1,0,5.556173099766475
Mixed Imperial,2023-03-26,Mixed Feelings,Curve,15,3,600.0,1.0,0,488.06,12,1,0,6.4,12,1,0,7.386300519683012
Mixed Imperial,2023-03-26,Oxford Ultimate,Mixed Feelings,15,9,515.4814780292847,1.0,0,308.9,6,1,0,3.9300000000000006,6,1,0,4.345654613306028
Mixed Imperial,2023-03-26,Plymouth Ultimate,Brixton,8,7,125.0,0.8885233166386386,0,-63.60000000000002,1,1,0,-1.0600000000000005,1,1,0,-1.0288818412993326
Mixed Imperial,2023-03-26,Plymouth Ultimate,Sharkbear!,10,3,600.0,0.8583950752789521,0,499.5999999999999,7,1,0,4.909999999999998,7,1,0,5.63171882417242
Mixed Imperial,2023-03-26,Plymouth Ultimate,Zoo 1,8,4,564.8086448756737,0.7947194142390263,0,-255.02999999999997,4,1,0,-3.7300000000000004,4,1,0,-4.037984450823508
Mixed Imperial,2023-03-26,Purple Cobras,Curve,15,10,453.6039151898044,1.0,0,508.32,5,1,0,6.630000000000001,5,1,0,7.40730261293594
Mixed Imperial,2023-03-26,Reading,Lemmings 1,12,7,520.5112660164395,1.0,0,215.30999999999995,5,1,0,2.3800000000000003,5,1,0,3.526059910962612
Mixed Imperial,2023-03-26,Thundering Herd,Oxford Ultimate,13,12,125.0,1.0,0,-98.27,1,1,0,-1.18,1,1,0,-1.2652365027629742
Mixed Imperial,2023-03-26,Thundering Herd,Purple Cobras,13,7,557.5316737222639,1.0,0,190.37,6,1,0,2.52,6,1,0,3.131048624628889
Mixed Imperial,2023-03-26,Zoo 1,Sharkbear!,7,3,600.0,0.7254762501100116,0,754.6299999999999,4,1,0,8.639999999999999,4,1,0,8.782095230044657
Spring Invite Padova,2023-04-21,DISConnection @ Spring Invite Padova,FlyHigh @ Spring Invite Padova,13,7,557.5316737222639,1.0,0,502.0,6,1,0,6.369999999999999,6,1,0,7.682915147603893
Spring Invite Padova,2023-04-21,DISConnection @ Spring Invite Padova,Gold @ Spring Invite Padova,15,9,515.4814780292847,1.0,0,327.07,6,1,0,4.3100000000000005,6,1,0,5.4249732351419375
Spring Invite Padova,2023-04-21,DISConnection @ Spring Invite Padova,HoneyMoon @ Spring Invite Padova,15,6,600.0,1.0,0,886.63,9,1,0,11.39,9,1,0,11.095047751215294
Spring Invite Padova,2023-04-21,DISConnection @ Spring Invite Padova,Lemmings 1,13,12,125.0,1.0,0,-199.08,1,1,0,-2.88,1,1,0,-2.8060618689075714
Spring Invite Padova,2023-04-21,DISConnection @ Spring Invite Padova,Owls UC @ Spring Invite Padova,15,6,600.0,1.0,0,650.23,9,1,0,7.75,9,1,0,8.604284856746823
Spring Invite Padova,2023-04-21,DISConnection @ Spring Invite Padova,Zombees @ Spring Invite Padova,14,8,536.0348119187572,1.0,0,767.1899999999999,6,1,0,9.89,6,1,0,10.138282040221721
Spring Invite Padova,2023-04-21,FlyHigh @ Spring Invite Padova,HoneyMoon @ Spring Invite Padova,15,7,600.0,1.0,0,384.63000000000005,8,1,0,5.0200000000000005,8,1,0,5.493292270223382
Spring Invite Padova,2023-04-21,FlyHigh @ Spring Invite Padova,HoneyMoon @ Spring Invite Padova,13,8,496.1596377856195,1.0,0,384.63000000000005,5,1,0,5.0200000000000005,5,1,0,5.493292270223382
Spring Invite Padova,2023-04-21,FlyHigh @ Spring Invite Padova,Zombees @ Spring Invite Padova,15,7,600.0,1.0,0,265.19,8,1,0,3.5200000000000005,8,1,0,3.755444305630707
Spring Invite Padova,2023-04-21,FucZH @ Spring Invite Padova,FlyHigh @ Spring Invite Padova,15,9,515.4814780292847,1.0,0,299.44,6,1,0,2.3299999999999996,6,1,0,3.35980806690095
Spring Invite Padova,2023-04-21,FucZH @ Spring Invite Padova,Gold @ Spring Invite Padova,14,8,536.0348119187572,1.0,0,124.50999999999999,6,1,0,0.27,6,1,0,0.6139068843598761
Spring Invite Padova,2023-04-21,FucZH @ Spring Invite Padova,Owls UC @ Spring Invite Padova,11,7,466.89332573293274,0.9733285267845752,0,447.67,4,1,0,3.7100000000000004,4,1,0,4.575364096300731
Spring Invite Padova,2023-04-21,Gold @ Spring Invite Padova,FucZH @ Spring Invite Padova,10,9,125.0,1.0,0,-124.50999999999999,1,1,0,-0.27,1,1,0,-0.6139068843598796
Spring Invite Padova,2023-04-21,Gold @ Spring Invite Padova,Owls UC @ Spring Invite Padova,12,8,441.15462425988915,1.0,0,323.15999999999997,4,1,0,3.4400000000000004,4,1,0,4.01153629533281
Spring Invite Padova,2023-04-21,Gold @ Spring Invite Padova,Zombees @ Spring Invite Padova,15,6,600.0,1.0,0,440.12,9,1,0,5.58,9,1,0,6.238199480652295
Spring Invite Padova,2023-04-21,HoneyMoon @ Spring Invite Padova,Zombees @ Spring Invite Padova,11,9,249.2068104043629,1.0,0,-119.44000000000005,2,1,0,-1.5,2,1,0,-1.9132716141841044
Spring Invite Padova,2023-04-21,Lemmings 1,FucZH @ Spring Invite Padova,15,5,600.0,1.0,0,401.64,10,1,0,6.92,10,1,0,7.247992857911914
Spring Invite Padova,2023-04-21,Lemmings 1,FucZH @ Spring Invite Padova,15,3,600.0,1.0,0,401.64,12,1,0,6.92,12,1,0,7.247992857911914
Spring Invite Padova,2023-04-21,Lemmings 1,Gold @ Spring Invite Padova,15,10,453.6039151898044,1.0,0,526.15,5,1,0,7.1899999999999995,5,1,0,7.709438143225345
Spring Invite Padova,2023-04-21,Lemmings 1,HoneyMoon @ Spring Invite Padova,15,1,600.0,1.0,1,1085.71,14,1,0,14.27,14,1,0,12.211409294572455
Spring Invite Padova,2023-04-21,Lemmings 1,Owls UC @ Spring Invite Padova,15,6,600.0,1.0,1,849.31,9,1,0,10.63,9,1,0,10.30458854881903
Spring Invite Padova,2023-04-21,Owls UC @ Spring Invite Padova,HoneyMoon @ Spring Invite Padova,15,8,564.8086448756737,1.0,0,236.40000000000003,7,1,0,3.6399999999999997,7,1,0,4.326409393433931
Spring Invite Padova,2023-04-21,Zombees @ Spring Invite Padova,FlyHigh @ Spring Invite Padova,15,14,125.0,1.0,0,-265.19,1,1,0,-3.5200000000000005,1,1,0,-3.7554443056307036
Spring Invite Padova,2023-04-21,Zombees @ Spring Invite Padova,Owls UC @ Spring Invite Padova,10,9,125.0,1.0,0,-116.95999999999998,1,1,0,-2.1399999999999997,1,1,0,-2.5053062859260713
G-Spot,2023-05-21,Antwerp Mixed @ G-Spot,Belgium U20 Mixed @ G-Spot,9,8,125.0,0.9459053029269173,0,28.959999999999994,1,1,0,0.6000000000000001,1,1,0,0.5899455364470203
G-Spot,2023-05-21,Antwerp Mixed @ G-Spot,Citadel Ultimate Frisbee @ G-Spot,13,3,600.0,1.0,0,294.38,10,1,0,4.73,10,1,0,5.305282996517814
G-Spot,2023-05-21,Antwerp Mixed @ G-Spot,Friss die Frisbee @ G-Spot,11,9,249.2068104043629,1.0,0,14.14,2,1,0,-0.38999999999999996,2,1,0,-0.5787126089992221
G-Spot,2023-05-21,Antwerp Mixed @ G-Spot,Scorillaz @ G-Spot,9,5,529.0591339672189,0.8583950752789521,0,22.929999999999993,4,1,0,0.18000000000000005,4,1,0,0.1769917852975258
G-Spot,2023-05-21,Belgian Mixed Masters @ G-Spot,Antwerp Mixed @ G-Spot,15,6,600.0,1.0,0,740.07,9,1,0,10.59,9,1,0,10.15821082197915
G-Spot,2023-05-21,Belgian Mixed Masters @ G-Spot,Belgium Mixed National @ G-Spot,9,7,279.3368557106305,0.9176629354822471,0,339.22,2,1,0,4.869999999999999,2,1,0,5.514709920315312
G-Spot,2023-05-21,Belgian Mixed Masters @ G-Spot,Bremen Ultimate @ G-Spot,13,5,600.0,1.0,0,202.25,8,1,0,2.8999999999999995,8,1,0,3.311330018586169
G-Spot,2023-05-21,Belgian Mixed Masters @ G-Spot,Netherlands Master Mixed @ G-Spot,14,5,600.0,1.0,0,613.6,9,1,0,9.1,9,1,0,9.147914844710055
G-Spot,2023-05-21,Belgian Mixed Masters @ G-Spot,Oxford Ultimate,14,4,600.0,1.0,0,757.27,10,1,0,10.91,10,1,0,10.244474120027572
G-Spot,2023-05-21,Belgian Mixed Masters @ G-Spot,Scorillaz @ G-Spot,15,4,600.0,1.0,0,763.0,11,1,0,10.77,11,1,0,10.253271229217493
G-Spot,2023-05-21,Belgian Mixed Masters @ G-Spot,Too Many Cooks @ G-Spot,13,8,496.1596377856195,1.0,0,365.06,5,1,0,5.6,5,1,0,6.166696751050296
G-Spot,2023-05-21,Belgium Mixed National @ G-Spot,Citadel Ultimate Frisbee @ G-Spot,15,4,600.0,1.0,0,695.23,11,1,0,10.45,11,1,0,10.026452511235696
G-Spot,2023-05-21,Belgium Mixed National @ G-Spot,Jetset Simba's @ G-Spot,11,10,125.0,1.0,0,-2.319999999999993,1,1,0,-0.6799999999999997,1,1,0,-0.6183992914334588
G-Spot,2023-05-21,Belgium Mixed National @ G-Spot,Spinners @ G-Spot,9,7,279.3368557106305,0.9176629354822471,0,-31.889999999999986,2,1,0,-0.09999999999999964,2,1,0,-0.0877489990055782
G-Spot,2023-05-21,Belgium Mixed National @ G-Spot,Too Many Cooks @ G-Spot,10,9,125.0,1.0,0,25.839999999999975,1,1,0,0.7300000000000004,1,1,0,0.7680776497385349
G-Spot,2023-05-21,Belgium Mixed National @ G-Spot,ZomBees @ G-Spot,11,8,365.60925011032475,1.0,0,306.89,3,1,0,3.63,3,1,0,3.9243468722394113
G-Spot,2023-05-21,Belgium U20 Mixed @ G-Spot,AUC Mxxxd @ G-Spot,10,5,573.8977938505714,0.8885233166386386,0,406.67,5,1,0,3.95,5,1,0,4.66971316495453
G-Spot,2023-05-21,Belgium U20 Mixed @ G-Spot,Citadel Ultimate Frisbee @ G-Spot,8,6,300.4922431832018,0.8583950752789521,0,265.42,2,1,0,4.13,2,1,0,4.781854717396385
G-Spot,2023-05-21,Belgium U20 Mixed @ G-Spot,Friss die Frisbee @ G-Spot,10,6,496.1596377856195,0.9176629354822471,0,-14.819999999999993,4,1,0,-0.99,4,1,0,-1.1668875418192517
G-Spot,2023-05-21,Belgium U20 Mixed @ G-Spot,W.underteam @ G-Spot,11,9,249.2068104043629,1.0,0,98.48,2,1,0,0.7599999999999998,2,1,0,0.6094143669681582
G-Spot,2023-05-21,Bremen Ultimate @ G-Spot,AUC Mxxxd @ G-Spot,11,5,600.0,0.9176629354822471,0,973.45,6,1,0,12.24,6,1,0,11.169836575729573
G-Spot,2023-05-21,Bremen Ultimate @ G-Spot,Belgium U20 Mixed @ G-Spot,15,4,600.0,1.0,0,566.78,11,1,0,8.29,11,1,0,8.461740336206528
G-Spot,2023-05-21,Bremen Ultimate @ G-Spot,Jetset Simba's @ G-Spot,10,9,125.0,1.0,0,134.65000000000003,1,1,0,1.29,1,1,0,1.7914094780157903
G-Spot,2023-05-21,Bremen Ultimate @ G-Spot,Jetset Simba's @ G-Spot,11,6,546.6949863040446,0.9459053029269173,0,134.65000000000003,5,1,0,1.29,5,1,0,1.7914094780157903
G-Spot,2023-05-21,Bremen Ultimate @ G-Spot,Spinners @ G-Spot,11,8,365.60925011032475,1.0,0,105.08000000000004,3,1,0,1.87,3,1,0,2.312415601107105
G-Spot,2023-05-21,Bremen Ultimate @ G-Spot,W.underteam @ G-Spot,15,3,600.0,1.0,0,665.26,12,1,0,9.05,12,1,0,8.86791370335996
G-Spot,2023-05-21,Bremen Ultimate @ G-Spot,ZomBees @ G-Spot,12,6,579.3107485100336,0.9733285267845752,0,443.86,6,1,0,5.6,6,1,0,6.068533368687376
G-Spot,2023-05-21,Citadel Ultimate Frisbee @ G-Spot,AUC Mxxxd @ G-Spot,7,6,125.0,0.8271701918685112,0,141.25,1,1,0,-0.17999999999999972,1,1,0,-0.12449714114377564
G-Spot,2023-05-21,Fly High @ G-Spot,AUC Mxxxd @ G-Spot,8,6,300.4922431832018,0.8583950752789521,0,202.87,2,1,0,2.62,2,1,0,3.3341523480437445
G-Spot,2023-05-21,Fly High @ G-Spot,AUC Mxxxd @ G-Spot,9,7,279.3368557106305,0.9176629354822471,0,202.87,2,1,0,2.62,2,1,0,3.3341523480437445
G-Spot,2023-05-21,Force Elektro MXD @ G-Spot,Fly High @ G-Spot,11,4,600.0,0.9176629354822471,0,573.37,7,1,0,6.380000000000001,7,1,0,6.544479072651949
G-Spot,2023-05-21,Force Elektro MXD @ G-Spot,Free Spirits @ G-Spot,6,4,365.60925011032475,0.7254762501100116,0,186.51,2,1,0,2.14,2,1,0,2.3285207307159226
G-Spot,2023-05-21,Force Elektro MXD @ G-Spot,Mainzelrenner @ G-Spot,10,9,125.0,1.0,0,-81.61000000000001,1,1,0,-0.23999999999999977,1,1,0,-0.1387460428698084
G-Spot,2023-05-21,Force Elektro MXD @ G-Spot,Seitensprung @ G-Spot,11,5,600.0,0.9176629354822471,0,210.78999999999996,6,1,0,2.4000000000000004,6,1,0,2.7756523249106273
G-Spot,2023-05-21,Force Elektro MXD @ G-Spot,ZomBees @ G-Spot,11,7,466.89332573293274,0.9733285267845752,0,246.64999999999998,4,1,0,2.3600000000000003,4,1,0,2.408232506486428
G-Spot,2023-05-21,Free Spirits @ G-Spot,Fly High @ G-Spot,10,8,262.66557693448596,0.9733285267845752,0,386.86,2,1,0,4.24,2,1,0,4.522244002959251
G-Spot,2023-05-21,Free Spirits @ G-Spot,Friss die Frisbee @ G-Spot,10,9,125.0,1.0,0,168.24,1,1,0,1.9200000000000002,1,1,0,2.0459193930136763
G-Spot,2023-05-21,Free Spirits @ G-Spot,Scorillaz @ G-Spot,8,5,453.6039151898044,0.8271701918685112,0,177.03,3,1,0,2.49,3,1,0,2.782170654317291
G-Spot,2023-05-21,Free Spirits @ G-Spot,Seitensprung @ G-Spot,12,10,238.1225775586291,1.0,0,24.28,2,1,0,0.26,2,1,0,0.4603553823050479
G-Spot,2023-05-21,Free Spirits @ G-Spot,Seitensprung @ G-Spot,9,8,125.0,0.9459053029269173,0,24.28,1,1,0,0.26,1,1,0,0.4603553823050479
G-Spot,2023-05-21,Friss die Frisbee @ G-Spot,Fly High @ G-Spot,12,10,238.1225775586291,1.0,0,218.62,2,1,0,2.3200000000000003,2,1,0,2.582519495466059
G-Spot,2023-05-21,Friss die Frisbee @ G-Spot,Fly High @ G-Spot,12,8,441.15462425988915,1.0,0,218.62,4,1,0,2.3200000000000003,4,1,0,2.582519495466059
G-Spot,2023-05-21,Friss die Frisbee @ G-Spot,Force Elektro MXD @ G-Spot,10,7,389.6652919127421,0.9459053029269173,0,-354.75,3,1,0,-4.0600000000000005,3,1,0,-4.283739727223287
G-Spot,2023-05-21,Jetset Simba's @ G-Spot,AUC Mxxxd @ G-Spot,15,4,600.0,1.0,0,838.8,11,1,0,10.95,11,1,0,10.293885237996463
G-Spot,2023-05-21,Jetset Simba's @ G-Spot,Belgium U20 Mixed @ G-Spot,14,6,600.0,1.0,0,432.13,8,1,0,7.0,8,1,0,7.1521792739448955
G-Spot,2023-05-21,Jetset Simba's @ G-Spot,Force Elektro MXD @ G-Spot,11,10,125.0,1.0,0,62.56,1,1,0,1.9499999999999997,1,1,0,2.1914555011163763
G-Spot,2023-05-21,Jetset Simba's @ G-Spot,Oxford Ultimate,14,5,600.0,1.0,0,420.37,9,1,0,6.72,9,1,0,6.815627336215112
G-Spot,2023-05-21,Jetset Simba's @ G-Spot,W.underteam @ G-Spot,15,6,600.0,1.0,0,530.61,9,1,0,7.76,9,1,0,7.6140953882468665
G-Spot,2023-05-21,Jetset Simba's @ G-Spot,ZomBees @ G-Spot,11,5,600.0,0.9176629354822471,0,309.21,6,1,0,4.31,6,1,0,4.494271681875809
G-Spot,2023-05-21,Mainzelrenner @ G-Spot,Fly High @ G-Spot,12,7,520.5112660164395,1.0,0,654.98,5,1,0,6.62,5,1,0,6.65636238665547
G-Spot,2023-05-21,Mainzelrenner @ G-Spot,Free Spirits @ G-Spot,9,7,279.3368557106305,0.9176629354822471,0,268.12,2,1,0,2.38,2,1,0,2.4637291537618893
G-Spot,2023-05-21,Mainzelrenner @ G-Spot,Friss die Frisbee @ G-Spot,13,8,496.1596377856195,1.0,0,436.36,5,1,0,4.3,5,1,0,4.410834268377258
G-Spot,2023-05-21,Mainzelrenner @ G-Spot,Seitensprung @ G-Spot,11,7,466.89332573293274,0.9733285267845752,0,292.4,4,1,0,2.6399999999999997,4,1,0,2.9094185968697737
G-Spot,2023-05-21,Mainzelrenner @ G-Spot,Seitensprung @ G-Spot,9,6,418.5661446562001,0.8885233166386386,0,292.4,3,1,0,2.6399999999999997,3,1,0,2.9094185968697737
G-Spot,2023-05-21,Mainzelrenner @ G-Spot,U24 Germany Mixed @ G-Spot,10,9,125.0,1.0,0,35.60000000000002,1,1,0,0.7199999999999998,1,1,0,0.30145940355553513
G-Spot,2023-05-21,Mainzelrenner @ G-Spot,W.underteam @ G-Spot,13,7,557.5316737222639,1.0,0,549.66,6,1,0,6.05,6,1,0,5.974162339892327
G-Spot,2023-05-21,Netherlands Master Mixed @ G-Spot,Antwerp Mixed @ G-Spot,12,6,579.3107485100336,0.9733285267845752,0,126.47,6,1,0,1.49,6,1,0,1.7211363721971793
G-Spot,2023-05-21,Netherlands Master Mixed @ G-Spot,Oxford Ultimate,12,5,600.0,0.9459053029269173,0,143.67000000000002,7,1,0,1.81,7,1,0,1.8793230078693988
G-Spot,2023-05-21,Netherlands Master Mixed @ G-Spot,Oxford Ultimate,10,7,389.6652919127421,0.9459053029269173,0,143.67000000000002,3,1,0,1.81,3,1,0,1.8793230078693988
G-Spot,2023-05-21,Netherlands Master Mixed @ G-Spot,W.underteam @ G-Spot,10,7,389.6652919127421,0.9459053029269173,0,253.91,3,1,0,2.8499999999999996,3,1,0,2.8920917496282783
G-Spot,2023-05-21,Oxford Ultimate,Antwerp Mixed @ G-Spot,11,10,125.0,1.0,0,-17.200000000000003,1,1,0,-0.32000000000000006,1,1,0,-0.1604938750654945
G-Spot,2023-05-21,Oxford Ultimate,Scorillaz @ G-Spot,13,9,418.5661446562001,1.0,0,5.72999999999999,4,1,0,-0.14,4,1,0,0.016499993345002295
G-Spot,2023-05-21,Oxford Ultimate,Scorillaz @ G-Spot,10,9,125.0,1.0,0,5.72999999999999,1,1,0,-0.14,1,1,0,0.016499993345002295
G-Spot,2023-05-21,Scorillaz @ G-Spot,Belgium U20 Mixed @ G-Spot,10,7,389.6652919127421,0.9459053029269173,0,6.030000000000001,3,1,0,0.42000000000000004,3,1,0,0.4131454791381479
G-Spot,2023-05-21,Scorillaz @ G-Spot,Netherlands Master Mixed @ G-Spot,9,8,125.0,0.9459053029269173,0,-149.39999999999998,1,1,0,-1.67,1,1,0,-1.8955617606455952
G-Spot,2023-05-21,Scorillaz @ G-Spot,W.underteam @ G-Spot,9,4,600.0,0.8271701918685112,0,104.51,5,1,0,1.1799999999999997,5,1,0,1.0214168724971628
G-Spot,2023-05-21,Seitensprung @ G-Spot,Citadel Ultimate Frisbee @ G-Spot,13,4,600.0,1.0,0,424.20000000000005,9,1,0,6.78,9,1,0,7.105150204243895
G-Spot,2023-05-21,Seitensprung @ G-Spot,Fly High @ G-Spot,9,5,529.0591339672189,0.8583950752789521,0,362.58000000000004,4,1,0,3.9800000000000004,4,1,0,4.099822719922997
G-Spot,2023-05-21,Seitensprung @ G-Spot,Friss die Frisbee @ G-Spot,10,8,262.66557693448596,0.9733285267845752,0,143.96,2,1,0,1.6600000000000001,2,1,0,1.5922290816752067
G-Spot,2023-05-21,Seitensprung @ G-Spot,Netherlands Master Mixed @ G-Spot,11,6,546.6949863040446,0.9459053029269173,0,3.3500000000000085,5,1,0,0.56,5,1,0,0.44836639328309325
G-Spot,2023-05-21,Spinners @ G-Spot,Citadel Ultimate Frisbee @ G-Spot,15,4,600.0,1.0,0,727.12,11,1,0,10.55,11,1,0,10.074806278623473
G-Spot,2023-05-21,Spinners @ G-Spot,Force Elektro MXD @ G-Spot,10,8,262.66557693448596,0.9733285267845752,0,92.13,2,1,0,1.3699999999999997,2,1,0,1.6693069749889489
G-Spot,2023-05-21,Spinners @ G-Spot,Mainzelrenner @ G-Spot,9,8,125.0,0.9459053029269173,0,10.519999999999982,1,1,0,1.13,1,1,0,1.5321380792202604
G-Spot,2023-05-21,Spinners @ G-Spot,Too Many Cooks @ G-Spot,12,6,579.3107485100336,0.9733285267845752,0,57.72999999999996,6,1,0,0.8300000000000001,6,1,0,0.8555703653222615
G-Spot,2023-05-21,Spinners @ G-Spot,U24 Germany Mixed @ G-Spot,11,9,249.2068104043629,1.0,0,46.120000000000005,2,1,0,1.8499999999999996,2,1,0,1.829841205637301
G-Spot,2023-05-21,Too Many Cooks @ G-Spot,Citadel Ultimate Frisbee @ G-Spot,15,4,600.0,1.0,0,669.3900000000001,11,1,0,9.719999999999999,11,1,0,9.586492555117662
G-Spot,2023-05-21,Too Many Cooks @ G-Spot,Free Spirits @ G-Spot,8,6,300.4922431832018,0.8583950752789521,0,220.91000000000003,2,1,0,2.6799999999999997,2,1,0,3.121004653744734
G-Spot,2023-05-21,Too Many Cooks @ G-Spot,Spinners @ G-Spot,10,8,262.66557693448596,0.9733285267845752,0,-57.72999999999996,2,1,0,-0.8300000000000001,2,1,0,-0.8555703653222615
G-Spot,2023-05-21,Too Many Cooks @ G-Spot,U24 Germany Mixed @ G-Spot,9,7,279.3368557106305,0.9176629354822471,0,-11.609999999999957,2,1,0,1.0199999999999996,2,1,0,0.9810973501632176
G-Spot,2023-05-21,Too Many Cooks @ G-Spot,ZomBees @ G-Spot,12,8,441.15462425988915,1.0,0,281.05,4,1,0,2.8999999999999995,4,1,0,3.1991261830784303
G-Spot,2023-05-21,U24 Germany Mixed @ G-Spot,Belgium Mixed National @ G-Spot,11,6,546.6949863040446,0.9459053029269173,0,-14.230000000000018,5,1,0,-1.75,5,1,0,-1.7433363035951253
G-Spot,2023-05-21,U24 Germany Mixed @ G-Spot,Citadel Ultimate Frisbee @ G-Spot,9,6,418.5661446562001,0.8885233166386386,0,681.0,3,1,0,8.7,3,1,0,8.980804089527417
G-Spot,2023-05-21,U24 Germany Mixed @ G-Spot,Free Spirits @ G-Spot,9,6,418.5661446562001,0.8885233166386386,0,232.51999999999998,3,1,0,1.6600000000000001,3,1,0,2.169430938771299
G-Spot,2023-05-21,U24 Germany Mixed @ G-Spot,Friss die Frisbee @ G-Spot,9,5,529.0591339672189,0.8583950752789521,0,400.76,4,1,0,3.58,4,1,0,4.133804500548003
G-Spot,2023-05-21,U24 Germany Mixed @ G-Spot,Oxford Ultimate,10,7,389.6652919127421,0.9459053029269173,0,403.82,3,1,0,4.29,3,1,0,4.8074428108148055
G-Spot,2023-05-21,W.underteam @ G-Spot,AUC Mxxxd @ G-Spot,8,2,600.0,0.7608859102526822,0,308.19000000000005,6,1,0,3.1900000000000004,6,1,0,4.112311131754566
G-Spot,2023-05-21,W.underteam @ G-Spot,Antwerp Mixed @ G-Spot,10,5,573.8977938505714,0.8885233166386386,0,-127.44,5,1,0,-1.3599999999999999,5,1,0,-1.1974465366669715
G-Spot,2023-05-21,ZomBees @ G-Spot,AUC Mxxxd @ G-Spot,13,4,600.0,1.0,0,529.59,9,1,0,6.640000000000001,9,1,0,7.300764945424252
G-Spot,2023-05-21,ZomBees @ G-Spot,Belgium U20 Mixed @ G-Spot,9,7,279.3368557106305,0.9176629354822471,0,122.91999999999999,2,1,0,2.6900000000000004,2,1,0,3.100907942032258
G-Spot,2023-05-21,ZomBees @ G-Spot,Netherlands Master Mixed @ G-Spot,12,8,441.15462425988915,1.0,0,-32.51,4,1,0,0.6000000000000001,4,1,0,0.8264123192857618
G-Spot,2023-05-21,ZomBees @ G-Spot,W.underteam @ G-Spot,11,8,365.60925011032475,1.0,0,221.4,3,1,0,3.45,3,1,0,3.6794194723566243
Elite Invite,2023-05-29,Deep Space @ Elite Invite,Mosquitos @ Elite Invite,15,4,600.0,1.0,0,265.03000000000003,11,1,0,4.44,11,1,0,4.749488597852409
Elite Invite,2023-05-29,Deep Space @ Elite Invite,PUC @ Elite Invite,15,9,515.4814780292847,1.0,0,533.26,6,1,0,7.550000000000001,6,1,0,7.446931393765226
Elite Invite,2023-05-29,Deep Space @ Elite Invite,Sesquidistus @ Elite Invite,13,10,328.14240231865136,1.0,0,-91.72999999999996,3,1,0,-0.75,3,1,0,-0.9497278448424513
Elite Invite,2023-05-29,Disconnection @ Elite Invite,Deep Space @ Elite Invite,14,13,125.0,1.0,0,95.19,1,1,0,0.79,1,1,0,1.0273888883827844
Elite Invite,2023-05-29,Disconnection @ Elite Invite,PUC @ Elite Invite,15,5,600.0,1.0,0,628.45,10,1,0,8.34,10,1,0,8.19563607110165
Elite Invite,2023-05-29,Disconnection @ Elite Invite,Reading,12,9,345.3654772346762,1.0,0,16.050000000000068,3,1,0,0.6699999999999999,3,1,0,0.3202013498184453
Elite Invite,2023-05-29,Disconnection @ Elite Invite,SMOG 1,15,12,300.4922431832018,1.0,0,173.31,3,1,0,1.7599999999999998,3,1,0,2.506035357971683
Elite Invite,2023-05-29,Grut @ Elite Invite,Deep Space @ Elite Invite,15,8,564.8086448756737,1.0,0,43.20999999999998,7,1,0,0.34999999999999964,7,1,0,0.2512265055272884
Elite Invite,2023-05-29,Grut @ Elite Invite,Deep Space @ Elite Invite,13,11,228.8403622143806,1.0,0,43.20999999999998,2,1,0,0.34999999999999964,2,1,0,0.2512265055272884
Elite Invite,2023-05-29,Grut @ Elite Invite,PUC @ Elite Invite,15,6,600.0,1.0,0,576.47,9,1,0,7.9,9,1,0,7.634675856239895
Elite Invite,2023-05-29,Grut @ Elite Invite,SMOG 1,12,9,345.3654772346762,1.0,0,121.32999999999998,3,1,0,1.3199999999999994,3,1,0,1.7440761685568376
Elite Invite,2023-05-29,Mosquitos @ Elite Invite,Grut @ Elite Invite,13,11,228.8403622143806,1.0,0,-308.24,2,1,0,-4.79,2,1,0,-4.974335705392143
Elite Invite,2023-05-29,Mosquitos @ Elite Invite,PUC @ Elite Invite,15,11,381.1647521399218,1.0,0,268.23,4,1,0,3.1100000000000003,4,1,0,3.2005579231493115
Elite Invite,2023-05-29,Mosquitos @ Elite Invite,PUC @ Elite Invite,12,10,238.1225775586291,1.0,0,268.23,2,1,0,3.1100000000000003,2,1,0,3.2005579231493115
Elite Invite,2023-05-29,Reading,Disconnection @ Elite Invite,14,11,313.3379659704299,1.0,0,-16.050000000000068,3,1,0,-0.6699999999999999,3,1,0,-0.3202013498184453
Elite Invite,2023-05-29,Reading,Grut @ Elite Invite,15,10,453.6039151898044,1.0,0,35.92999999999995,5,1,0,-0.22999999999999954,5,1,0,0.4573581896424006
Elite Invite,2023-05-29,Reading,Mosquitos @ Elite Invite,15,9,515.4814780292847,1.0,0,344.16999999999996,6,1,0,4.5600000000000005,6,1,0,5.377321924782823
Elite Invite,2023-05-29,Reading,SMOG 1,15,5,600.0,1.0,0,157.25999999999993,10,1,0,1.0899999999999999,10,1,0,2.193657428073479
Elite Invite,2023-05-29,Reading,Sesquidistus @ Elite Invite,15,10,453.6039151898044,1.0,0,-12.590000000000032,5,1,0,-0.6299999999999999,5,1,0,-0.2422289407802083
Elite Invite,2023-05-29,SMOG 1,Mosquitos @ Elite Invite,15,12,300.4922431832018,1.0,0,186.91000000000003,3,1,0,3.4700000000000006,3,1,0,3.35980806690095
Elite Invite,2023-05-29,Sesquidistus @ Elite Invite,Disconnection @ Elite Invite,14,13,125.0,1.0,0,-3.4600000000000364,1,1,0,-0.040000000000000036,1,1,0,-0.07799929696760444
Elite Invite,2023-05-29,Sesquidistus @ Elite Invite,PUC @ Elite Invite,15,8,564.8086448756737,1.0,0,624.99,7,1,0,8.3,7,1,0,8.140765733473174
Elite Invite,2023-05-29,Sesquidistus @ Elite Invite,SMOG 1,15,7,600.0,1.0,0,169.84999999999997,8,1,0,1.7199999999999998,8,1,0,2.430147254089082
Elite Invite,2023-05-29,Sesquidistus @ Elite Invite,SMOG 1,13,7,557.5316737222639,1.0,0,169.84999999999997,6,1,0,1.7199999999999998,6,1,0,2.430147254089082
Windmill,2023-06-16,Austria Mixed @ Windmill,DTU @ Windmill,15,0,600.0,1.0,0,951.52,15,1,0,15.43,15,1,0,12.900801869369719
Windmill,2023-06-16,Austria Mixed @ Windmill,Denmark Mixed @ Windmill,14,4,600.0,1.0,0,171.18,10,1,0,4.01,10,1,0,5.459490713266177
Windmill,2023-06-16,Belgium Mixed @ Windmill,DTU @ Windmill,15,5,600.0,1.0,0,744.4100000000001,10,1,0,10.76,10,1,0,10.611297734479713
Windmill,2023-06-16,Chang Chi and the Legend of 20ish Rings @ Windmill,Disckatus Ultimate Madrid @ Windmill,11,5,600.0,0.9176629354822471,0,671.62,6,1,0,9.85,6,1,0,10.036402145700077
Windmill,2023-06-16,Chang Chi and the Legend of 20ish Rings @ Windmill,Ellipsis @ Windmill,12,11,125.0,1.0,0,-54.49000000000001,1,1,0,-0.7300000000000004,1,1,0,-0.7209440912517486
Windmill,2023-06-16,Czech Republic Mixed @ Windmill,Belgium Mixed @ Windmill,11,11,0.0,1.0,0,134.52999999999997,0,1,0,1.5499999999999998,0,1,0,1.170614775478306
Windmill,2023-06-16,DTU @ Windmill,Kingdom of Raptors @ Windmill,11,10,125.0,1.0,0,-280.64000000000004,1,1,0,-4.33,1,1,0,-4.882008154465041
Windmill,2023-06-16,Deep Space,Disckatus Ultimate Madrid @ Windmill,15,3,600.0,1.0,0,468.7900000000001,12,1,0,6.7,12,1,0,7.302481808379362
Windmill,2023-06-16,Deep Space,Too many cooks @ Windmill,15,9,515.4814780292847,1.0,0,295.6500000000001,6,1,0,4.609999999999999,6,1,0,5.238890806338677
Windmill,2023-06-16,Disckatus Ultimate Madrid @ Windmill,Rainbow Brigade @ Windmill,12,10,238.1225775586291,1.0,0,220.74,2,1,0,2.98,2,1,0,3.560051372990671
Windmill,2023-06-16,Disconnection @ Windmill,Kingdom of Raptors @ Windmill,15,4,600.0,1.0,0,593.2,11,1,0,8.7,11,1,0,8.825850468298711
Windmill,2023-06-16,Disconnection @ Windmill,PUC @ Windmill,15,9,515.4814780292847,1.0,0,221.40000000000003,6,1,0,3.1299999999999994,6,1,0,3.247056074710372
Windmill,2023-06-16,Ellipsis @ Windmill,Estonia Mixed @ Windmill,12,11,125.0,1.0,0,155.31999999999994,1,1,0,1.9699999999999998,1,1,0,2.286049985300078
Windmill,2023-06-16,Ellipsis @ Windmill,Pampered cats @ Windmill,15,7,600.0,1.0,0,529.27,8,1,0,8.44,8,1,0,8.959605578215559
Windmill,2023-06-16,Estonia Mixed @ Windmill,Frizstyle FBF @ Windmill,15,7,600.0,1.0,0,268.19000000000005,8,1,0,3.3499999999999996,8,1,0,4.54950077293865
Windmill,2023-06-16,EuroTrash @ Windmill,New Age Mix @ Windmill,11,8,365.60925011032475,1.0,0,85.08999999999997,3,1,0,0.5699999999999998,3,1,0,0.5090544358882028
Windmill,2023-06-16,EuroTrash @ Windmill,Rainbow Brigade @ Windmill,14,7,582.8868714046324,1.0,0,487.15,7,1,0,7.3,7,1,0,7.567787701315183
Windmill,2023-06-16,FRuBB @ Windmill,Denmark Mixed @ Windmill,12,12,0.0,1.0,0,-236.17000000000002,0,1,0,-2.87,0,1,0,-3.49203007345986
Windmill,2023-06-16,FRuBB @ Windmill,New Age Mix @ Windmill,11,8,365.60925011032475,1.0,0,-80.59000000000003,3,1,0,-1.73,3,1,0,-2.1620872893518666
Windmill,2023-06-16,Farmer Brown's Greenhouse (FBG) @ Windmill,Frizstyle FBF @ Windmill,14,12,220.95664314305532,1.0,0,286.69000000000005,2,1,0,3.29,2,1,0,3.5784472764288786
Windmill,2023-06-16,Farmer Brown's Greenhouse (FBG) @ Windmill,HORANGI @ Windmill,14,8,536.0348119187572,1.0,0,482.75000000000006,6,1,0,5.91,6,1,0,6.077939158094104
Windmill,2023-06-16,Farmer Brown's Greenhouse (FBG) @ Windmill,Switzerland Mixed @ Windmill,13,10,328.14240231865136,1.0,0,291.36000000000007,3,1,0,3.42,3,1,0,3.887991644320259
Windmill,2023-06-16,Finland Mixed @ Windmill,Fusion Falcons Ultimate Club @ Windmill,13,10,328.14240231865136,1.0,0,670.11,3,1,0,7.85,3,1,0,9.10256141917787
Windmill,2023-06-16,Finland Mixed @ Windmill,NOISE Ultimate @ Windmill,11,9,249.2068104043629,1.0,0,29.93999999999994,2,1,0,-1.1600000000000001,2,1,0,-0.981844139213651
Windmill,2023-06-16,Force Elektro MXD @ Windmill,Fusion Falcons Ultimate Club @ Windmill,13,7,557.5316737222639,1.0,0,204.04000000000002,6,1,0,1.8800000000000001,6,1,0,3.0434248833794015
Windmill,2023-06-16,Force Elektro MXD @ Windmill,Norway Mixed @ Windmill,9,5,529.0591339672189,0.8583950752789521,0,287.36,4,1,0,3.33,4,1,0,3.6660237695386044
Windmill,2023-06-16,France Mixed @ Windmill,Austria Mixed @ Windmill,15,6,600.0,1.0,0,391.18999999999994,9,1,0,5.1,9,1,0,4.926886127974338
Windmill,2023-06-16,France Mixed @ Windmill,Great Britain Mixed,14,10,398.70186369942724,1.0,0,-156.8900000000001,4,1,0,-1.1799999999999997,4,1,0,-1.5106118260103916
Windmill,2023-06-16,France Mixed @ Windmill,SMOG 1,15,5,600.0,1.0,0,562.51,10,1,0,8.37,10,1,0,8.874253537503169
Windmill,2023-06-16,Germany Mixed @ Windmill,Fusion Falcons Ultimate Club @ Windmill,15,3,600.0,1.0,0,1200.38,12,1,0,17.86,12,1,0,13.670289337163155
Windmill,2023-06-16,Germany Mixed @ Windmill,Ireland Mixed @ Windmill,15,9,515.4814780292847,1.0,0,163.7700000000001,6,1,0,3.130000000000001,6,1,0,3.6716648249571584
Windmill,2023-06-16,Germany Mixed @ Windmill,Poland Mixed @ Windmill,15,6,600.0,1.0,0,395.23,9,1,0,6.34,9,1,0,7.1167791480464295
Windmill,2023-06-16,Great Britain Mixed,Finland Mixed @ Windmill,15,2,600.0,1.0,0,537.2800000000001,13,1,0,9.32,13,1,0,9.475590721202153
Windmill,2023-06-16,Great Britain Mixed,Swedish Royals @ Windmill,15,9,515.4814780292847,1.0,0,440.25,6,1,0,5.719999999999999,6,1,0,6.100489725093453
Windmill,2023-06-16,Grut @ Windmill,Deep Space,14,5,600.0,1.0,0,440.39,9,1,0,6.090000000000001,9,1,0,7.313349450359773
Windmill,2023-06-16,Grut @ Windmill,EuroTrash @ Windmill,12,10,238.1225775586291,1.0,0,642.77,2,1,0,8.47,2,1,0,9.539304791226204
Windmill,2023-06-16,Grut @ Windmill,FRuBB @ Windmill,14,9,473.8676990361691,1.0,0,808.45,5,1,0,10.77,5,1,0,10.9620544766866
Windmill,2023-06-16,HORANGI @ Windmill,LoL Mixed Ultimate Team @ Windmill,15,5,600.0,1.0,0,438.7,10,1,0,7.55,10,1,0,8.070675401393444
Windmill,2023-06-16,Ireland Mixed @ Windmill,Chang Chi and the Legend of 20ish Rings @ Windmill,14,9,473.8676990361691,1.0,0,213.76,5,1,0,2.8900000000000006,5,1,0,3.2963440939139765
Windmill,2023-06-16,Ireland Mixed @ Windmill,Denmark Mixed @ Windmill,15,9,515.4814780292847,1.0,0,548.48,6,1,0,7.85,6,1,0,8.685926388684756
Windmill,2023-06-16,Italy Mixed @ Windmill,Frizstyle FBF @ Windmill,13,10,328.14240231865136,1.0,0,493.74,3,1,0,6.05,3,1,0,6.957683734010068
Windmill,2023-06-16,Italy Mixed @ Windmill,NOISE Ultimate @ Windmill,13,11,228.8403622143806,1.0,0,307.4,2,1,0,4.29,2,1,0,5.392348861150403
Windmill,2023-06-16,Italy Mixed @ Windmill,Poland Mixed @ Windmill,11,11,0.0,1.0,0,142.41999999999996,0,1,0,1.7799999999999994,0,1,0,1.8815376476828725
Windmill,2023-06-16,Lithuania Mixed @ Windmill,Belgium Mixed @ Windmill,15,5,600.0,1.0,0,172.08000000000004,10,1,0,3.0999999999999996,10,1,0,3.8599926975662164
Windmill,2023-06-16,Lithuania Mixed @ Windmill,Estonia Mixed @ Windmill,12,11,125.0,1.0,0,-97.74000000000001,1,1,0,-1.2800000000000002,1,1,0,-1.4801674496465722
Windmill,2023-06-16,Lithuania Mixed @ Windmill,Norway Mixed @ Windmill,15,6,600.0,1.0,0,707.6,9,1,0,10.77,9,1,0,10.75468306710567
Windmill,2023-06-16,LoL Mixed Ultimate Team @ Windmill,Steamhuck @ Windmill,12,11,125.0,1.0,0,-280.9,1,1,0,-3.51,1,1,0,-3.538102959491889
Windmill,2023-06-16,NOISE Ultimate @ Windmill,PUC @ Windmill,11,9,249.2068104043629,1.0,0,279.94000000000005,2,1,0,3.65,2,1,0,3.8704956913416773
Windmill,2023-06-16,New Age Mix @ Windmill,Disconnection @ Windmill,15,9,515.4814780292847,1.0,0,-249.07999999999998,6,1,0,-2.7499999999999996,6,1,0,-2.8574140407810695
Windmill,2023-06-16,PUC @ Windmill,Czech Republic Mixed @ Windmill,11,10,125.0,1.0,0,-226.5,1,1,0,-2.4099999999999997,1,1,0,-2.4848873369605275
Windmill,2023-06-16,Pampered cats @ Windmill,Czech Republic Mixed @ Windmill,11,10,125.0,1.0,0,-238.65999999999997,1,1,0,-3.6399999999999997,1,1,0,-3.6921043808865193
Windmill,2023-06-16,Pampered cats @ Windmill,Rainbow Brigade @ Windmill,13,7,557.5316737222639,1.0,0,417.58000000000004,6,1,0,5.12,6,1,0,5.829637272243787
Windmill,2023-06-16,Poland Mixed @ Windmill,Steamhuck @ Windmill,15,4,600.0,1.0,0,705.1800000000001,11,1,0,10.93,11,1,0,10.914646323110208
Windmill,2023-06-16,SMOG 1,Force Elektro MXD @ Windmill,15,6,600.0,1.0,0,283.95000000000005,9,1,0,5.74,9,1,0,6.465926092722004
Windmill,2023-06-16,Swedish Royals @ Windmill,LoL Mixed Ultimate Team @ Windmill,15,3,600.0,1.0,0,948.07,12,1,0,14.370000000000001,12,1,0,12.3202385817352
Windmill,2023-06-16,Swedish Royals @ Windmill,SMOG 1,11,10,125.0,1.0,0,279.15000000000003,1,1,0,3.83,1,1,0,5.0396460116008015
Windmill,2023-06-16,Switzerland Mixed @ Windmill,Kingdom of Raptors @ Windmill,15,8,564.8086448756737,1.0,0,460.72999999999996,7,1,0,7.33,7,1,0,7.745250519016999
Windmill,2023-06-16,Switzerland Mixed @ Windmill,Norway Mixed @ Windmill,15,2,600.0,1.0,0,532.48,13,1,0,8.57,13,1,0,8.727699858672853
Windmill,2023-06-16,Too many cooks @ Windmill,HORANGI @ Windmill,12,11,125.0,1.0,0,66.6,1,1,0,-0.55,1,1,0,-0.5480059942044768
Windmill,2023-06-16,Too many cooks @ Windmill,Steamhuck @ Windmill,15,10,453.6039151898044,1.0,0,224.39999999999998,5,1,0,3.4899999999999998,5,1,0,4.702876121786293
Grey Towers,2023-06-17,Contested 1st,Black Sheep Mixed,12,5,600.0,0.9459053029269173,1,600.99,7,1,0,7.7,7,1,0,7.967295882247441
Grey Towers,2023-06-17,Contested 1st,Glasgow Mixed 2,11,6,546.6949863040446,0.9459053029269173,0,441.71000000000004,5,1,0,5.53,5,1,0,5.797132523268864
Grey Towers,2023-06-17,Contested 1st,LLLeeds 1,9,8,125.0,0.9459053029269173,0,31.69999999999999,1,1,0,-0.5800000000000001,1,1,0,-0.33819267800244823
Grey Towers,2023-06-17,Glasgow Mixed,Mamak Ult,15,3,600.0,1.0,1,991.55,12,1,0,12.219999999999999,12,1,0,11.241098281992283
Grey Towers,2023-06-17,Glasgow Mixed,Newcastle Brown,14,4,600.0,1.0,0,399.38,10,1,0,6.25,10,1,0,7.028708443520081
Grey Towers,2023-06-17,Glasgow Mixed,Sheffield Steal,13,8,496.1596377856195,1.0,0,717.4599999999999,5,1,0,8.87,5,1,0,9.311486647836265
Grey Towers,2023-06-17,Glasgow Mixed 2,Black Sheep Mixed,9,6,418.5661446562001,0.8885233166386386,0,159.27999999999997,3,1,0,2.17,3,1,0,2.7307189042774915
Grey Towers,2023-06-17,LLLeeds 1,Black Sheep Mixed,13,4,600.0,1.0,0,569.29,9,1,0,8.280000000000001,9,1,0,8.207203427922657
Grey Towers,2023-06-17,LLLeeds 1,Glasgow Mixed 2,11,3,600.0,0.9176629354822471,0,410.01000000000005,8,1,0,6.11,8,1,0,6.0823265709953915
Grey Towers,2023-06-17,Mamak Ult,Sheffield Steal,9,8,125.0,0.9459053029269173,0,-274.09000000000003,1,1,0,-3.3499999999999996,1,1,0,-3.6081396175469163
Grey Towers,2023-06-17,Nemesis,Black Sheep Mixed,12,5,600.0,0.9459053029269173,0,462.36,7,1,0,6.16,7,1,0,6.5086062794385064
Grey Towers,2023-06-17,Nemesis,Contested 1st,9,8,125.0,0.9459053029269173,0,-138.63,1,1,0,-1.54,1,1,0,-1.8955617606455952
Grey Towers,2023-06-17,Nemesis,Glasgow Mixed 2,10,6,496.1596377856195,0.9176629354822471,0,303.08000000000004,4,1,0,3.99,4,1,0,4.10190454909273
Grey Towers,2023-06-17,Nemesis,LLLeeds 1,11,10,125.0,1.0,0,-106.93,1,1,0,-2.12,1,1,0,-2.22740815575796
Grey Towers,2023-06-17,Newcastle Brown,Mamak Ult,13,9,418.5661446562001,1.0,0,592.17,4,1,0,5.97,4,1,0,6.492159231180612
Grey Towers,2023-06-17,Newcastle Brown,Sheffield Steal,14,8,536.0348119187572,1.0,0,318.0799999999999,6,1,0,2.62,6,1,0,3.2191649752568203
Mooxed,2023-06-17,BN1,Mixed Feelings,15,6,600.0,1.0,0,241.9,9,1,0,3.1100000000000003,9,1,0,3.630742240934481
Mooxed,2023-06-17,Bristol Mixed,Curve,15,4,600.0,1.0,0,337.54999999999995,11,1,0,4.010000000000001,11,1,0,4.548819755802533
Mooxed,2023-06-17,Bristol Mixed,Guildford,14,4,600.0,1.0,0,433.69999999999993,10,1,0,5.03,10,1,0,5.4581893728318
Mooxed,2023-06-17,Brixton,Bristol Mixed,12,5,600.0,0.9459053029269173,0,-307.19999999999993,7,1,0,-3.45,7,1,0,-3.8998824212080745
Mooxed,2023-06-17,Flyght Mixed,Birmingham Ultimate,14,8,536.0348119187572,1.0,0,256.5,6,1,0,2.5599999999999996,6,1,0,3.101625882510554
Mooxed,2023-06-17,GB Mixed Masters,Purple Cobras,15,2,600.0,1.0,0,473.4,13,1,0,6.96,13,1,0,7.218637429069837
Mooxed,2023-06-17,GB Mixed Masters,Reading 2,14,8,536.0348119187572,1.0,0,352.91999999999996,6,1,0,5.17,6,1,0,5.484847899223919
Mooxed,2023-06-17,Lemmings 1,BN1,14,8,536.0348119187572,1.0,0,501.28,6,1,0,5.5600000000000005,6,1,0,6.544479072651949
Mooxed,2023-06-17,Lemmings 1,South Wales Storm Mixed,15,3,600.0,1.0,1,1608.09,12,1,0,16.91,12,1,0,13.448686500940688
Mooxed,2023-06-17,Lemmings 1,Thundering Herd,15,9,515.4814780292847,1.0,0,532.55,6,1,0,5.92,6,1,0,6.942369986580175
Mooxed,2023-06-17,Lemmings 2,Flyght Mixed,15,10,453.6039151898044,1.0,0,601.08,5,1,0,8.25,5,1,0,8.250718604578935
Mooxed,2023-06-17,Lemmings 2,GB Mixed Masters,12,11,125.0,1.0,0,-47.629999999999995,1,1,0,-0.99,1,1,0,-1.076645360216359
Mooxed,2023-06-17,Lemmings 2,Reading 2,15,14,125.0,1.0,0,305.28999999999996,1,1,0,4.18,1,1,0,4.527016316408655
Mooxed,2023-06-17,Mixed Feelings,Thundering Herd 2,15,5,600.0,1.0,1,741.5799999999999,10,1,0,8.4,10,1,0,8.918011034848409
Mooxed,2023-06-17,Norwich Ultimate,Curve,10,4,600.0,0.8583950752789521,0,106.88999999999999,6,1,0,1.3500000000000014,6,1,0,1.6218847205318099
Mooxed,2023-06-17,Norwich Ultimate,South Wales Storm Mixed,11,7,466.89332573293274,0.9733285267845752,0,483.7399999999999,4,1,0,3.1900000000000013,4,1,0,4.495636984444648
Mooxed,2023-06-17,Norwich Ultimate,Thundering Herd 2,14,8,536.0348119187572,1.0,0,360.40999999999997,6,1,0,3.3500000000000014,6,1,0,3.7294216970267904
Mooxed,2023-06-17,Oxford Ultimate,BN1,12,6,579.3107485100336,0.9733285267845752,0,66.99999999999999,6,1,0,0.8200000000000001,6,1,0,0.7688256813451702
Mooxed,2023-06-17,Oxford Ultimate,Mixed Feelings,12,9,345.3654772346762,1.0,0,308.9,3,1,0,3.9300000000000006,3,1,0,4.345654613306028
Mooxed,2023-06-17,Purple Cobras,Birmingham Ultimate,13,5,600.0,1.0,0,431.81,8,1,0,4.84,8,1,0,5.382550092380708
Mooxed,2023-06-17,Purple Cobras,Flyght Mixed,11,4,600.0,0.9176629354822471,0,175.31,7,1,0,2.2800000000000002,7,1,0,2.4637291537618893
Mooxed,2023-06-17,Reading 2,Brixton,15,7,600.0,1.0,0,598.45,8,1,0,7.86,8,1,0,8.425363221497648
Mooxed,2023-06-17,Thundering Herd,Oxford Ultimate,10,9,125.0,1.0,0,-98.27,1,1,0,-1.18,1,1,0,-1.2652365027629742
Mooxed,2023-06-17,Thundering Herd,South Wales Storm Mixed,15,2,600.0,1.0,1,1075.54,13,1,0,10.99,13,1,0,11.121127665451723
Mooxed,2023-06-17,Thundering Herd 2,Curve,15,9,515.4814780292847,1.0,0,-253.51999999999998,6,1,0,-2.0,6,1,0,-2.165759246599718
Mooxed,2023-06-17,Zoo 1,Birmingham Ultimate,11,9,249.2068104043629,1.0,0,145.26999999999998,2,1,0,1.4399999999999995,2,1,0,1.3277657525361946
Mooxed,2023-06-17,Zoo 1,Brixton,15,6,600.0,1.0,0,191.42999999999995,9,1,0,2.67,9,1,0,3.0657107386296083
Mooxed,2023-06-17,Zoo 1,Guildford,15,5,600.0,1.0,0,317.92999999999995,10,1,0,4.25,10,1,0,4.6771623272986105
Windmill,2023-06-17,Austria Mixed @ Windmill,Estonia Mixed @ Windmill,10,3,600.0,0.8583950752789521,0,-62.710000000000036,7,1,0,0.29000000000000004,7,1,0,0.7389014661005309
Windmill,2023-06-17,Belgium Mixed @ Windmill,HORANGI @ Windmill,14,10,398.70186369942724,1.0,0,194.43,4,1,0,1.59,4,1,0,2.0495995043474444
Windmill,2023-06-17,Belgium Mixed @ Windmill,New Age Mix @ Windmill,15,11,381.1647521399218,1.0,0,119.64999999999998,4,1,0,0.48,4,1,0,0.9273159314274864
Windmill,2023-06-17,Belgium Mixed @ Windmill,PUC @ Windmill,13,10,328.14240231865136,1.0,0,91.97000000000003,3,1,0,0.8599999999999999,3,1,0,1.3314862874271434
Windmill,2023-06-17,Chang Chi and the Legend of 20ish Rings @ Windmill,Lithuania Mixed @ Windmill,15,6,600.0,1.0,0,198.56999999999994,9,1,0,2.5199999999999996,9,1,0,3.0254422015853457
Windmill,2023-06-17,Chang Chi and the Legend of 20ish Rings @ Windmill,Poland Mixed @ Windmill,12,11,125.0,1.0,0,17.699999999999932,1,1,0,0.3199999999999985,1,1,0,0.6378650943397872
Windmill,2023-06-17,Czech Republic Mixed @ Windmill,Force Elektro MXD @ Windmill,13,4,600.0,1.0,0,382.68999999999994,9,1,0,5.89,9,1,0,6.535367603185907
Windmill,2023-06-17,Czech Republic Mixed @ Windmill,Fusion Falcons Ultimate Club @ Windmill,13,8,496.1596377856195,1.0,0,586.73,5,1,0,7.77,5,1,0,8.800805203007105
Windmill,2023-06-17,Czech Republic Mixed @ Windmill,New Age Mix @ Windmill,13,9,418.5661446562001,1.0,0,254.17999999999995,4,1,0,2.03,4,1,0,2.0878576776484437
Windmill,2023-06-17,Czech Republic Mixed @ Windmill,Switzerland Mixed @ Windmill,15,12,300.4922431832018,1.0,0,137.57,3,1,0,0.6499999999999995,3,1,0,0.765833531951559
Windmill,2023-06-17,Deep Space,EuroTrash @ Windmill,12,10,238.1225775586291,1.0,0,202.38000000000005,2,1,0,2.38,2,1,0,3.2263187729142473
Windmill,2023-06-17,Deep Space,Frizstyle FBF @ Windmill,14,10,398.70186369942724,1.0,0,166.19000000000005,4,1,0,1.4399999999999995,4,1,0,2.1077116114188676
Windmill,2023-06-17,Deep Space,New Age Mix @ Windmill,14,10,398.70186369942724,1.0,0,287.47,4,1,0,2.9499999999999997,4,1,0,3.7083046960638093
Windmill,2023-06-17,Denmark Mixed @ Windmill,Disconnection @ Windmill,11,10,125.0,1.0,0,-93.5,1,1,0,-1.6099999999999994,1,1,0,-1.507642192211648
Windmill,2023-06-17,Denmark Mixed @ Windmill,New Age Mix @ Windmill,12,12,0.0,1.0,0,155.57999999999998,0,1,0,1.1400000000000001,0,1,0,1.376119696625814
Windmill,2023-06-17,Denmark Mixed @ Windmill,Switzerland Mixed @ Windmill,12,9,345.3654772346762,1.0,0,38.97000000000003,3,1,0,-0.2400000000000002,3,1,0,0.04499986500048614
Windmill,2023-06-17,Disckatus Ultimate Madrid @ Windmill,Fusion Falcons Ultimate Club @ Windmill,13,7,557.5316737222639,1.0,0,151.23000000000002,6,1,0,1.9900000000000002,6,1,0,3.717457324648457
Windmill,2023-06-17,Disconnection @ Windmill,EuroTrash @ Windmill,15,8,564.8086448756737,1.0,0,163.99,7,1,0,2.1799999999999997,7,1,0,2.3636400577069487
Windmill,2023-06-17,Disconnection @ Windmill,Too many cooks @ Windmill,15,7,600.0,1.0,0,257.26,8,1,0,4.41,8,1,0,4.438224062419508
Windmill,2023-06-17,Ellipsis @ Windmill,Austria Mixed @ Windmill,13,11,228.8403622143806,1.0,0,218.02999999999997,2,1,0,1.6799999999999997,2,1,0,1.5588514452907312
Windmill,2023-06-17,Ellipsis @ Windmill,EuroTrash @ Windmill,15,8,564.8086448756737,1.0,0,459.7,7,1,0,6.26,7,1,0,7.437885498256097
Windmill,2023-06-17,Ellipsis @ Windmill,Grut @ Windmill,14,13,125.0,1.0,0,-183.07000000000005,1,1,0,-2.210000000000001,1,1,0,-3.0693039119220344
Windmill,2023-06-17,Estonia Mixed @ Windmill,Chang Chi and the Legend of 20ish Rings @ Windmill,14,11,313.3379659704299,1.0,0,-100.82999999999993,3,1,0,-1.2399999999999993,3,1,0,-1.5766548150941357
Windmill,2023-06-17,Estonia Mixed @ Windmill,Farmer Brown's Greenhouse (FBG) @ Windmill,13,8,496.1596377856195,1.0,0,-18.5,5,1,0,0.05999999999999961,5,1,0,1.0467956703761487
Windmill,2023-06-17,EuroTrash @ Windmill,Switzerland Mixed @ Windmill,13,12,125.0,1.0,0,-31.519999999999982,1,1,0,-0.8100000000000005,1,1,0,-0.8249168641004729
Windmill,2023-06-17,Farmer Brown's Greenhouse (FBG) @ Windmill,FRuBB @ Windmill,14,8,536.0348119187572,1.0,0,488.56000000000006,6,1,0,6.53,6,1,0,6.924677367081635
Windmill,2023-06-17,Farmer Brown's Greenhouse (FBG) @ Windmill,SMOG 1,15,8,564.8086448756737,1.0,0,252.53000000000003,7,1,0,2.92,7,1,0,3.245626332919805
Windmill,2023-06-17,Farmer Brown's Greenhouse (FBG) @ Windmill,Swedish Royals @ Windmill,9,9,0.0,0.9733285267845752,0,-26.620000000000005,0,1,0,-0.9100000000000001,0,1,0,-1.9346637839193495
Windmill,2023-06-17,Finland Mixed @ Windmill,Denmark Mixed @ Windmill,11,9,249.2068104043629,1.0,0,181.97999999999996,2,1,0,0.9699999999999998,2,1,0,1.1877581700307225
Windmill,2023-06-17,Finland Mixed @ Windmill,HORANGI @ Windmill,12,8,441.15462425988915,1.0,0,412.34,4,1,0,3.2199999999999998,4,1,0,3.630742240934481
Windmill,2023-06-17,Finland Mixed @ Windmill,Pampered cats @ Windmill,15,9,515.4814780292847,1.0,0,322.03999999999996,6,1,0,3.7199999999999998,6,1,0,4.12895276069456
Windmill,2023-06-17,Force Elektro MXD @ Windmill,Kingdom of Raptors @ Windmill,10,9,125.0,1.0,0,215.61,1,1,0,2.09,1,1,0,2.3146120776398433
Windmill,2023-06-17,Force Elektro MXD @ Windmill,Steamhuck @ Windmill,11,9,249.2068104043629,1.0,0,104.07000000000001,2,1,0,1.2899999999999998,2,1,0,1.6404129974836685
Windmill,2023-06-17,France Mixed @ Windmill,Ireland Mixed @ Windmill,12,11,125.0,1.0,0,13.889999999999986,1,1,0,1.2599999999999998,1,1,0,0.921338715001438
Windmill,2023-06-17,Frizstyle FBF @ Windmill,FRuBB @ Windmill,15,8,564.8086448756737,1.0,0,201.87,7,1,0,3.24,7,1,0,3.7603647958167308
Windmill,2023-06-17,Frizstyle FBF @ Windmill,Too many cooks @ Windmill,12,10,238.1225775586291,1.0,0,129.46,2,1,0,3.1700000000000004,2,1,0,3.2927749959785153
Windmill,2023-06-17,Germany Mixed @ Windmill,Austria Mixed @ Windmill,15,5,600.0,1.0,0,541.07,10,1,0,6.970000000000001,10,1,0,7.27440833285419
Windmill,2023-06-17,Germany Mixed @ Windmill,France Mixed @ Windmill,14,10,398.70186369942724,1.0,0,149.8800000000001,4,1,0,1.870000000000001,4,1,0,2.792308114369135
Windmill,2023-06-17,Germany Mixed @ Windmill,Great Britain Mixed,15,12,300.4922431832018,1.0,0,-7.009999999999991,3,1,0,0.6900000000000013,3,1,0,1.3061834172039077
Windmill,2023-06-17,Great Britain Mixed,Ellipsis @ Windmill,14,8,536.0348119187572,1.0,0,330.05000000000007,6,1,0,4.6,6,1,0,4.883349217455898
Windmill,2023-06-17,Great Britain Mixed,Germany Mixed @ Windmill,14,11,313.3379659704299,1.0,0,7.009999999999991,3,1,0,-0.6900000000000013,3,1,0,-1.306183417203906
Windmill,2023-06-17,Great Britain Mixed,Grut @ Windmill,14,10,398.70186369942724,1.0,0,146.98000000000002,4,1,0,2.389999999999999,4,1,0,1.9435133810593221
Windmill,2023-06-17,Grut @ Windmill,Ireland Mixed @ Windmill,13,7,557.5316737222639,1.0,0,23.800000000000068,6,1,0,0.05000000000000071,6,1,0,0.48358235966410135
Windmill,2023-06-17,Grut @ Windmill,Italy Mixed @ Windmill,15,10,453.6039151898044,1.0,0,112.84000000000003,5,1,0,1.4800000000000004,5,1,0,2.556311730756182
Windmill,2023-06-17,HORANGI @ Windmill,Disckatus Ultimate Madrid @ Windmill,15,8,564.8086448756737,1.0,0,106.53999999999999,7,1,0,2.64,7,1,0,3.0160876195160498
Windmill,2023-06-17,Ireland Mixed @ Windmill,Austria Mixed @ Windmill,15,7,600.0,1.0,0,377.29999999999995,8,1,0,3.84,8,1,0,4.088022465583315
Windmill,2023-06-17,Ireland Mixed @ Windmill,France Mixed @ Windmill,11,7,466.89332573293274,0.9733285267845752,0,-13.889999999999986,4,1,0,-1.2599999999999998,4,1,0,-0.9213387150014363
Windmill,2023-06-17,Italy Mixed @ Windmill,Chang Chi and the Legend of 20ish Rings @ Windmill,12,10,238.1225775586291,1.0,0,124.72000000000003,2,1,0,1.4600000000000009,2,1,0,1.2503419729481564
Windmill,2023-06-17,Italy Mixed @ Windmill,Disconnection @ Windmill,15,6,600.0,1.0,0,365.94,9,1,0,4.8100000000000005,9,1,0,5.958378708253438
Windmill,2023-06-17,Italy Mixed @ Windmill,France Mixed @ Windmill,12,10,238.1225775586291,1.0,0,-102.92999999999995,2,1,0,-2.6899999999999995,2,1,0,-2.9800857277980786
Windmill,2023-06-17,Kingdom of Raptors @ Windmill,LoL Mixed Ultimate Team @ Windmill,15,9,515.4814780292847,1.0,0,169.36,6,1,0,2.7099999999999995,6,1,0,2.8834253158909213
Windmill,2023-06-17,Kingdom of Raptors @ Windmill,Norway Mixed @ Windmill,13,11,228.8403622143806,1.0,0,71.75000000000001,2,1,0,1.2399999999999998,2,1,0,1.4043748681558803
Windmill,2023-06-17,Lithuania Mixed @ Windmill,SMOG 1,13,11,228.8403622143806,1.0,0,136.29000000000002,2,1,0,1.6999999999999993,2,1,0,2.827045010758603
Windmill,2023-06-17,LoL Mixed Ultimate Team @ Windmill,DTU @ Windmill,12,4,600.0,0.9459053029269173,0,111.28000000000003,8,1,0,1.62,8,1,0,2.131967296461987
Windmill,2023-06-17,NOISE Ultimate @ Windmill,Belgium Mixed @ Windmill,13,11,228.8403622143806,1.0,0,187.97000000000003,2,1,0,2.79,2,1,0,2.598527367519903
Windmill,2023-06-17,NOISE Ultimate @ Windmill,FRuBB @ Windmill,15,6,600.0,1.0,0,388.21000000000004,9,1,0,5.0,9,1,0,5.4672967660926055
Windmill,2023-06-17,NOISE Ultimate @ Windmill,HORANGI @ Windmill,14,11,313.3379659704299,1.0,0,382.40000000000003,3,1,0,4.38,3,1,0,4.540645939981626
Windmill,2023-06-17,NOISE Ultimate @ Windmill,SMOG 1,15,11,381.1647521399218,1.0,0,152.18,4,1,0,1.3899999999999997,4,1,0,1.5321380792202604
Windmill,2023-06-17,Norway Mixed @ Windmill,DTU @ Windmill,14,12,220.95664314305532,1.0,0,208.89000000000001,2,1,0,3.09,2,1,0,3.586933849263943
Windmill,2023-06-17,Norway Mixed @ Windmill,LoL Mixed Ultimate Team @ Windmill,15,10,453.6039151898044,1.0,0,97.60999999999999,5,1,0,1.4699999999999998,5,1,0,1.5061573305255287
Windmill,2023-06-17,Norway Mixed @ Windmill,Rainbow Brigade @ Windmill,12,11,125.0,1.0,0,-13.810000000000002,1,1,0,-0.45999999999999996,1,1,0,-0.8219259044142149
Windmill,2023-06-17,PUC @ Windmill,Disckatus Ultimate Madrid @ Windmill,13,11,228.8403622143806,1.0,0,208.99999999999997,2,1,0,3.37,2,1,0,3.7068963380758255
Windmill,2023-06-17,PUC @ Windmill,FRuBB @ Windmill,15,10,453.6039151898044,1.0,0,108.26999999999998,5,1,0,1.35,5,1,0,1.7625699875654135
Windmill,2023-06-17,PUC @ Windmill,Pampered cats @ Windmill,11,10,125.0,1.0,0,12.159999999999968,1,1,0,1.2300000000000002,1,1,0,1.2585342735204605
Windmill,2023-06-17,Pampered cats @ Windmill,Force Elektro MXD @ Windmill,12,8,441.15462425988915,1.0,0,144.03,4,1,0,2.25,4,1,0,3.184805427480754
Windmill,2023-06-17,Poland Mixed @ Windmill,Deep Space,13,6,600.0,1.0,0,185.13,7,1,0,2.830000000000001,7,1,0,3.4565418720881667
Windmill,2023-06-17,Poland Mixed @ Windmill,Lithuania Mixed @ Windmill,13,10,328.14240231865136,1.0,0,180.87,3,1,0,2.200000000000001,3,1,0,2.408232506486428
Windmill,2023-06-17,Rainbow Brigade @ Windmill,DTU @ Windmill,12,10,238.1225775586291,1.0,0,222.70000000000002,2,1,0,3.55,2,1,0,4.351837265438032
Windmill,2023-06-17,Rainbow Brigade @ Windmill,Fusion Falcons Ultimate Club @ Windmill,11,9,249.2068104043629,1.0,0,-69.51,2,1,0,-0.9899999999999998,2,1,0,0.1672430693652771
Windmill,2023-06-17,Rainbow Brigade @ Windmill,LoL Mixed Ultimate Team @ Windmill,11,9,249.2068104043629,1.0,0,111.41999999999999,2,1,0,1.9299999999999997,2,1,0,2.3153442138936278
Windmill,2023-06-17,SMOG 1,Frizstyle FBF @ Windmill,10,10,0.0,1.0,0,34.160000000000025,0,1,0,0.3700000000000001,0,1,0,0.3509359495085569
Windmill,2023-06-17,Steamhuck @ Windmill,DTU @ Windmill,15,7,600.0,1.0,0,392.18,8,1,0,5.13,8,1,0,5.486147294663162
Windmill,2023-06-17,Steamhuck @ Windmill,Fusion Falcons Ultimate Club @ Windmill,10,8,262.66557693448596,0.9733285267845752,0,99.97,2,1,0,0.5900000000000003,2,1,0,1.4348494330467148
Windmill,2023-06-17,Steamhuck @ Windmill,Kingdom of Raptors @ Windmill,12,10,238.1225775586291,1.0,0,111.53999999999999,2,1,0,0.8000000000000003,2,1,0,0.6857716124671356
Windmill,2023-06-17,Swedish Royals @ Windmill,Estonia Mixed @ Windmill,13,11,228.8403622143806,1.0,0,45.120000000000005,2,1,0,0.8500000000000005,2,1,0,0.8959322912816319
Windmill,2023-06-17,Swedish Royals @ Windmill,Lithuania Mixed @ Windmill,14,13,125.0,1.0,0,142.86,1,1,0,2.130000000000001,1,1,0,2.3621772799574394
Windmill,2023-06-17,Swedish Royals @ Windmill,Poland Mixed @ Windmill,15,8,564.8086448756737,1.0,0,-38.00999999999999,7,1,0,-0.07000000000000028,7,1,0,-0.04724984372124652
Windmill,2023-06-17,Switzerland Mixed @ Windmill,Finland Mixed @ Windmill,9,8,125.0,0.9459053029269173,0,-220.95,1,1,0,-0.7299999999999995,1,1,0,-1.232465261772738
Windmill,2023-06-17,Too many cooks @ Windmill,Disckatus Ultimate Madrid @ Windmill,13,12,125.0,1.0,0,173.14,1,1,0,2.09,1,1,0,2.486346148355267
Windmill,2023-06-17,Too many cooks @ Windmill,Pampered cats @ Windmill,13,10,328.14240231865136,1.0,0,-23.700000000000017,3,1,0,-0.050000000000000044,3,1,0,-0.014249995713129238
Grey Towers,2023-06-18,Black Sheep Mixed,Mamak Ult,12,5,600.0,0.9459053029269173,0,54.65999999999997,7,1,0,0.4399999999999995,7,1,0,0.33594381415669794
Grey Towers,2023-06-18,Black Sheep Mixed,Sheffield Steal,13,10,328.14240231865136,1.0,0,-219.43000000000006,3,1,0,-2.91,3,1,0,-3.289919435542668
Grey Towers,2023-06-18,Contested 1st,Nemesis,15,8,564.8086448756737,1.0,0,138.63,7,1,0,1.54,7,1,0,1.8955617606455952
Grey Towers,2023-06-18,Glasgow Mixed,Contested 1st,15,7,600.0,1.0,0,335.9,8,1,0,4.08,8,1,0,5.144489257343341
Grey Towers,2023-06-18,Glasgow Mixed,Newcastle Brown,15,2,600.0,1.0,0,399.38,13,1,0,6.25,13,1,0,7.028708443520081
Grey Towers,2023-06-18,Glasgow Mixed 2,Mamak Ult,11,9,249.2068104043629,1.0,0,213.93999999999994,2,1,0,2.6099999999999994,2,1,0,3.0542101184034998
Grey Towers,2023-06-18,Glasgow Mixed 2,Sheffield Steal,10,9,125.0,1.0,0,-60.15000000000009,1,1,0,-0.7400000000000002,1,1,0,-0.5824569910011341
Grey Towers,2023-06-18,LLLeeds 1,Mamak Ult,15,6,600.0,1.0,1,623.95,9,1,0,8.719999999999999,9,1,0,8.439726487739716
Grey Towers,2023-06-18,LLLeeds 1,Sheffield Steal,15,4,600.0,1.0,0,349.85999999999996,11,1,0,5.37,11,1,0,5.587852014451066
Grey Towers,2023-06-18,Newcastle Brown,Nemesis,12,10,238.1225775586291,1.0,0,75.14999999999998,2,1,0,-0.6299999999999999,2,1,0,-0.3561830326875839
Mooxed,2023-06-18,BN1,Purple Cobras,11,6,546.6949863040446,0.9459053029269173,0,221.64000000000001,5,1,0,2.88,5,1,0,3.6046063830054607
Mooxed,2023-06-18,BN1,Zoo 1,12,9,345.3654772346762,1.0,0,508.18000000000006,3,1,0,6.28,3,1,0,7.302481808379362
Mooxed,2023-06-18,Birmingham Ultimate,South Wales Storm Mixed,10,4,600.0,0.8583950752789521,0,453.3599999999999,6,1,0,3.630000000000001,6,1,0,5.259951448496498
Mooxed,2023-06-18,Birmingham Ultimate,Thundering Herd 2,10,6,496.1596377856195,0.9176629354822471,0,330.03,4,1,0,3.790000000000001,4,1,0,4.519516514414999
Mooxed,2023-06-18,Bristol Mixed,Birmingham Ultimate,9,7,279.3368557106305,0.9176629354822471,0,261.03999999999996,2,1,0,2.2199999999999998,2,1,0,2.197327091615417
Mooxed,2023-06-18,Bristol Mixed,Brixton,12,6,579.3107485100336,0.9733285267845752,0,307.19999999999993,6,1,0,3.45,6,1,0,3.8998824212080727
Mooxed,2023-06-18,Bristol Mixed,Curve,14,6,600.0,1.0,0,337.54999999999995,8,1,0,4.010000000000001,8,1,0,4.548819755802533
Mooxed,2023-06-18,Brixton,Guildford,9,6,418.5661446562001,0.8885233166386386,0,126.5,3,1,0,1.58,3,1,0,1.7211363721971793
Mooxed,2023-06-18,Curve,South Wales Storm Mixed,10,8,262.66557693448596,0.9733285267845752,0,376.8499999999999,2,1,0,1.8399999999999999,2,1,0,2.9699987691563123
Mooxed,2023-06-18,Flyght Mixed,Norwich Ultimate,15,6,600.0,1.0,0,226.12,9,1,0,2.999999999999999,9,1,0,3.909670880961361
Mooxed,2023-06-18,Guildford,Curve,12,9,345.3654772346762,1.0,0,-96.14999999999998,3,1,0,-1.0199999999999996,3,1,0,-1.0221633923134252
Mooxed,2023-06-18,Guildford,Thundering Herd 2,13,6,600.0,1.0,0,157.37,7,1,0,0.9800000000000004,7,1,0,1.1549594221111725
Mooxed,2023-06-18,Lemmings 1,GB Mixed Masters,12,6,579.3107485100336,0.9733285267845752,0,249.52,6,1,0,1.48,6,1,0,2.789411966376658
Mooxed,2023-06-18,Lemmings 1,Thundering Herd,15,8,564.8086448756737,1.0,0,532.55,7,1,0,5.92,7,1,0,6.942369986580175
Mooxed,2023-06-18,Lemmings 2,GB Mixed Masters,10,9,125.0,1.0,0,-47.629999999999995,1,1,0,-0.99,1,1,0,-1.076645360216359
Mooxed,2023-06-18,Mixed Feelings,Flyght Mixed,11,9,249.2068104043629,1.0,0,155.05,2,1,0,2.05,2,1,0,2.436719606021665
Mooxed,2023-06-18,Mixed Feelings,Purple Cobras,11,10,125.0,1.0,0,-20.25999999999999,1,1,0,-0.23000000000000043,1,1,0,-0.027749968341918674
Mooxed,2023-06-18,Oxford Ultimate,BN1,13,6,600.0,1.0,0,66.99999999999999,7,1,0,0.8200000000000001,7,1,0,0.7688256813451702
Mooxed,2023-06-18,Oxford Ultimate,Mixed Feelings,15,7,600.0,1.0,0,308.9,8,1,0,3.9300000000000006,8,1,0,4.345654613306028
Mooxed,2023-06-18,Oxford Ultimate,Reading 2,15,10,453.6039151898044,1.0,0,168.15999999999997,5,1,0,1.91,5,1,0,2.309486807723818
Mooxed,2023-06-18,Purple Cobras,Norwich Ultimate,14,5,600.0,1.0,0,401.43,9,1,0,5.279999999999999,9,1,0,6.111752641001139
Mooxed,2023-06-18,Reading 2,Flyght Mixed,11,10,125.0,1.0,0,295.79,1,1,0,4.07,1,1,0,4.464897920350175
Mooxed,2023-06-18,Reading 2,Zoo 1,14,10,398.70186369942724,1.0,0,407.02000000000004,4,1,0,5.19,4,1,0,6.054727884257208
Mooxed,2023-06-18,Thundering Herd,Lemmings 2,12,11,125.0,1.0,0,-235.4,1,1,0,-3.45,1,1,0,-3.54447673735263
Mooxed,2023-06-18,Thundering Herd 2,South Wales Storm Mixed,10,9,125.0,1.0,0,123.32999999999993,1,1,0,-0.16000000000000014,1,1,0,0.827907757992973
Mooxed,2023-06-18,Zoo 1,Norwich Ultimate,10,9,125.0,1.0,0,114.88999999999999,1,1,0,1.879999999999999,1,1,0,2.1708995413222034
Windmill,2023-06-18,Chang Chi and the Legend of 20ish Rings @ Windmill,Swedish Royals @ Windmill,14,12,220.95664314305532,1.0,0,55.70999999999992,2,1,0,0.3899999999999988,2,1,0,0.6850231783659257
Windmill,2023-06-18,Czech Republic Mixed @ Windmill,EuroTrash @ Windmill,15,8,564.8086448756737,1.0,0,169.08999999999997,7,1,0,1.46,7,1,0,1.5862964352533844
Windmill,2023-06-18,Deep Space,NOISE Ultimate @ Windmill,14,12,220.95664314305532,1.0,0,-20.149999999999977,2,1,0,-0.3200000000000003,2,1,0,0.2332312016738154
Windmill,2023-06-18,Denmark Mixed @ Windmill,PUC @ Windmill,11,7,466.89332573293274,0.9733285267845752,0,127.90000000000003,4,1,0,1.52,4,1,0,1.7781005999852475
Windmill,2023-06-18,Disconnection @ Windmill,Frizstyle FBF @ Windmill,15,12,300.4922431832018,1.0,0,127.80000000000001,3,1,0,1.2399999999999993,3,1,0,1.2250155886988168
Windmill,2023-06-18,FRuBB @ Windmill,Kingdom of Raptors @ Windmill,15,13,214.17926913507503,1.0,0,263.53,2,1,0,4.220000000000001,2,1,0,4.874630748067872
Windmill,2023-06-18,Farmer Brown's Greenhouse (FBG) @ Windmill,Lithuania Mixed @ Windmill,14,12,220.95664314305532,1.0,0,116.24000000000001,2,1,0,1.2200000000000006,2,1,0,0.4363768308651732
Windmill,2023-06-18,Finland Mixed @ Windmill,Belgium Mixed @ Windmill,12,8,441.15462425988915,1.0,0,217.90999999999997,4,1,0,1.63,4,1,0,1.6352255880860191
Windmill,2023-06-18,Force Elektro MXD @ Windmill,LoL Mixed Ultimate Team @ Windmill,14,6,600.0,1.0,0,384.97,8,1,0,4.8,8,1,0,5.0482935405119775
Windmill,2023-06-18,France Mixed @ Windmill,Austria Mixed @ Windmill,14,8,536.0348119187572,1.0,0,391.18999999999994,6,1,0,5.1,6,1,0,4.926886127974338
Windmill,2023-06-18,Fusion Falcons Ultimate Club @ Windmill,DTU @ Windmill,13,8,496.1596377856195,1.0,0,292.21000000000004,5,1,0,4.539999999999999,5,1,0,4.198174162917219
Windmill,2023-06-18,Great Britain Mixed,Italy Mixed @ Windmill,14,12,220.95664314305532,1.0,0,259.82000000000005,2,1,0,3.869999999999999,2,1,0,4.402611036869317
Windmill,2023-06-18,Grut @ Windmill,Germany Mixed @ Windmill,12,11,125.0,1.0,0,-139.97000000000003,1,1,0,-3.08,1,1,0,-3.213440831460101
Windmill,2023-06-18,Ireland Mixed @ Windmill,Ellipsis @ Windmill,12,10,238.1225775586291,1.0,0,159.26999999999998,2,1,0,2.16,2,1,0,2.602892093662156
Windmill,2023-06-18,New Age Mix @ Windmill,HORANGI @ Windmill,13,9,418.5661446562001,1.0,0,74.78000000000003,4,1,0,1.11,4,1,0,1.1318445215201152
Windmill,2023-06-18,Pampered cats @ Windmill,Disckatus Ultimate Madrid @ Windmill,12,11,125.0,1.0,0,196.84,1,1,0,2.14,1,1,0,2.5002024408352703
Windmill,2023-06-18,Poland Mixed @ Windmill,Estonia Mixed @ Windmill,14,10,398.70186369942724,1.0,0,83.13,4,1,0,0.9200000000000008,4,1,0,0.9430047132312822
Windmill,2023-06-18,Steamhuck @ Windmill,Norway Mixed @ Windmill,11,8,365.60925011032475,1.0,0,183.29000000000002,3,1,0,2.04,3,1,0,2.0812380379597677
Windmill,2023-06-18,Switzerland Mixed @ Windmill,SMOG 1,10,9,125.0,1.0,0,-38.83000000000004,1,1,0,-0.5,1,1,0,-0.6805325021113955
Windmill,2023-06-18,Too many cooks @ Windmill,Rainbow Brigade @ Windmill,14,9,473.8676990361691,1.0,0,393.88,5,1,0,5.07,5,1,0,5.817535170142332
TOWWAPM,2023-07-15,Big Fish Little Fish,BN1,11,9,249.2068104043629,1.0,0,-144.18000000000004,2,1,0,-1.67,2,1,0,-1.7781005999852457
TOWWAPM,2023-07-15,Bristol Mixed,Black Sheep Mixed,11,8,365.60925011032475,1.0,0,335.78,3,1,0,3.79,3,1,0,4.0567601373253055
TOWWAPM,2023-07-15,Bristol Mixed,Red Mixed,12,3,600.0,0.9459053029269173,0,242.40999999999997,9,1,0,4.29,9,1,0,4.661583896317648
TOWWAPM,2023-07-15,Brixton,Cambridge Ultimate 2,11,9,249.2068104043629,1.0,0,168.76,2,1,0,3.0299999999999994,2,1,0,2.827768363329856
TOWWAPM,2023-07-15,Cambridge Ultimate,GB Mixed Masters,9,7,279.3368557106305,0.9176629354822471,0,-114.41,2,1,0,-2.78,2,1,0,-2.5322738135086293
TOWWAPM,2023-07-15,Cambridge Ultimate,Purple Cobras,13,9,418.5661446562001,1.0,0,358.99,4,1,0,4.18,4,1,0,5.100762395888715
TOWWAPM,2023-07-15,Contested 1st,Curve,9,9,0.0,0.9733285267845752,0,602.76,0,1,0,7.920000000000001,0,1,0,8.344925547741013
TOWWAPM,2023-07-15,Contested 1st,LLLeeds 1,11,7,466.89332573293274,0.9733285267845752,0,31.69999999999999,4,1,0,-0.5800000000000001,4,1,0,-0.33819267800244823
TOWWAPM,2023-07-15,Deep Space,Flyght Mixed,15,1,600.0,1.0,1,1088.31,14,1,0,13.08,14,1,0,11.946596143865015
TOWWAPM,2023-07-15,Deep Space,SMOG 2,10,8,262.66557693448596,0.9733285267845752,0,512.87,2,1,0,5.85,2,1,0,7.012894696421892
TOWWAPM,2023-07-15,Deep Space,Thundering Herd,13,6,600.0,1.0,0,722.6300000000001,7,1,0,8.28,7,1,0,9.171431549913159
TOWWAPM,2023-07-15,Exe and the City,Glasgow Mixed,13,7,557.5316737222639,1.0,0,258.51,6,1,0,2.88,6,1,0,3.6942179864865494
TOWWAPM,2023-07-15,Exe and the City,Lemmings 2,12,9,345.3654772346762,1.0,0,263.08000000000004,3,1,0,2.2800000000000002,3,1,0,3.569250747334067
TOWWAPM,2023-07-15,Exe and the City,Mixed Feelings,15,5,600.0,1.0,0,709.11,10,1,0,8.48,10,1,0,9.038334793530126
TOWWAPM,2023-07-15,GB Mixed Masters,Purple Cobras,13,2,600.0,1.0,0,473.4,11,1,0,6.96,11,1,0,7.218637429069837
TOWWAPM,2023-07-15,Glasgow Mixed,Mixed Feelings,14,8,536.0348119187572,1.0,0,450.6,6,1,0,5.6000000000000005,6,1,0,6.275369967206835
TOWWAPM,2023-07-15,LLLeeds 1,Curve,9,8,125.0,0.9459053029269173,0,571.06,1,1,0,8.5,1,1,0,8.575554371932487
TOWWAPM,2023-07-15,Lemmings 1,Cambridge Ultimate,10,5,573.8977938505714,0.8885233166386386,0,363.93,5,1,0,4.26,5,1,0,5.159704207349709
TOWWAPM,2023-07-15,Lemmings 1,GB Mixed Masters,10,9,125.0,1.0,0,249.52,1,1,0,1.48,1,1,0,2.789411966376658
TOWWAPM,2023-07-15,Lemmings 1,Purple Cobras,11,4,600.0,0.9176629354822471,1,722.9200000000001,7,1,0,8.44,7,1,0,9.185975854892458
TOWWAPM,2023-07-15,Lemmings 2,Glasgow Mixed,11,8,365.60925011032475,1.0,0,-4.569999999999993,3,1,0,0.6,3,1,0,0.1327465343379508
TOWWAPM,2023-07-15,Lemmings 2,Mixed Feelings,15,4,600.0,1.0,0,446.03,11,1,0,6.2,11,1,0,6.384478788460392
TOWWAPM,2023-07-15,Newcastle Brown,Nemesis,10,7,389.6652919127421,0.9459053029269173,0,75.14999999999998,3,1,0,-0.6299999999999999,3,1,0,-0.3561830326875839
TOWWAPM,2023-07-15,Oxford Ultimate,BN1,11,9,249.2068104043629,1.0,0,66.99999999999999,2,1,0,0.8200000000000001,2,1,0,0.7688256813451702
TOWWAPM,2023-07-15,Oxford Ultimate,Big Fish Little Fish,12,9,345.3654772346762,1.0,0,211.18,3,1,0,2.49,3,1,0,2.5315451820611443
TOWWAPM,2023-07-15,Reading 2,Brixton,15,5,600.0,1.0,0,598.45,10,1,0,7.86,10,1,0,8.425363221497648
TOWWAPM,2023-07-15,Reading 2,Cambridge Ultimate 2,15,3,600.0,1.0,1,767.21,12,1,0,10.89,12,1,0,10.175644952092945
TOWWAPM,2023-07-15,Reading 2,Zoo 1,10,7,389.6652919127421,0.9459053029269173,0,407.02000000000004,3,1,0,5.19,3,1,0,6.054727884257208
TOWWAPM,2023-07-15,Red Mixed,Black Sheep Mixed,9,7,279.3368557106305,0.9176629354822471,0,93.37,2,1,0,-0.5,2,1,0,-0.6603229577998135
TOWWAPM,2023-07-15,SLAB,Black Sheep Mixed,15,3,600.0,1.0,0,896.94,12,1,0,13.71,12,1,0,11.968739883325245
TOWWAPM,2023-07-15,SLAB,Bristol Mixed,14,1,600.0,1.0,0,561.1600000000001,13,1,0,9.92,13,1,0,10.08919748108411
TOWWAPM,2023-07-15,SLAB,Red Mixed,15,2,600.0,1.0,0,803.57,13,1,0,14.21,13,1,0,12.200513895218716
TOWWAPM,2023-07-15,SMOG 1,BN1,11,5,600.0,0.9176629354822471,0,559.33,6,1,0,6.8500000000000005,6,1,0,7.618548498543021
TOWWAPM,2023-07-15,SMOG 1,Big Fish Little Fish,15,4,600.0,1.0,1,703.51,11,1,0,8.52,11,1,0,8.863033591001134
TOWWAPM,2023-07-15,SMOG 1,Oxford Ultimate,14,6,600.0,1.0,0,492.33000000000004,8,1,0,6.03,8,1,0,7.032805040842117
TOWWAPM,2023-07-15,SMOG 2,Flyght Mixed,15,3,600.0,1.0,0,575.44,12,1,0,7.23,12,1,0,7.860675264277969
TOWWAPM,2023-07-15,SMOG 2,Thundering Herd,11,6,546.6949863040446,0.9459053029269173,0,209.76,5,1,0,2.43,5,1,0,3.0225641295313785
TOWWAPM,2023-07-15,Sheffield Steal,Nemesis,8,6,300.4922431832018,0.8583950752789521,0,-242.92999999999995,2,1,0,-3.25,2,1,0,-3.557220224851692
TOWWAPM,2023-07-15,Sheffield Steal,Newcastle Brown,10,9,125.0,1.0,0,-318.0799999999999,1,1,0,-2.62,1,1,0,-3.219164975256824
TOWWAPM,2023-07-15,Thundering Herd,Flyght Mixed,11,9,249.2068104043629,1.0,0,365.68,2,1,0,4.800000000000001,2,1,0,5.40932087633302
TOWWAPM,2023-07-15,Zoo 1,Brixton,11,3,600.0,0.9176629354822471,0,191.42999999999995,8,1,0,2.67,8,1,0,3.0657107386296083
TOWWAPM,2023-07-15,Zoo 1,Cambridge Ultimate 2,14,3,600.0,1.0,0,360.18999999999994,11,1,0,5.699999999999999,11,1,0,5.6748311409793395
TOWWAPM,2023-07-16,BN1,Flyght Mixed,13,1,600.0,1.0,0,396.95000000000005,12,1,0,5.16,12,1,0,5.837912511542353
TOWWAPM,2023-07-16,Black Sheep Mixed,Brixton,9,8,125.0,0.9459053029269173,0,-28.58000000000004,1,1,0,-0.33999999999999986,1,1,0,-0.16874288121976377
TOWWAPM,2023-07-16,Bristol Mixed,Zoo 1,11,7,466.89332573293274,0.9733285267845752,0,115.76999999999998,4,1,0,0.7800000000000002,4,1,0,0.8809849164530732
TOWWAPM,2023-07-16,Cambridge Ultimate,Lemmings 2,15,10,453.6039151898044,1.0,0,-66.78,5,1,0,-1.79,5,1,0,-1.4734828801396898
TOWWAPM,2023-07-16,Cambridge Ultimate,SMOG 2,12,6,579.3107485100336,0.9733285267845752,0,-41.14,6,1,0,-0.77,6,1,0,-0.9288101894192664
TOWWAPM,2023-07-16,Cambridge Ultimate 2,Brixton,12,6,579.3107485100336,0.9733285267845752,0,-168.76,6,1,0,-3.0299999999999994,6,1,0,-2.827768363329856
TOWWAPM,2023-07-16,Contested 1st,BN1,13,8,496.1596377856195,1.0,0,-127.20000000000002,5,1,0,-1.5899999999999999,5,1,0,-2.3607144561360034
TOWWAPM,2023-07-16,Contested 1st,Sheffield Steal,11,10,125.0,1.0,0,381.55999999999995,1,1,0,4.79,1,1,0,5.294124586190215
TOWWAPM,2023-07-16,Curve,Black Sheep Mixed,14,12,220.95664314305532,1.0,0,-1.7699999999999818,2,1,0,-0.22000000000000064,2,1,0,-0.5360216630589676
TOWWAPM,2023-07-16,Curve,Cambridge Ultimate 2,15,11,381.1647521399218,1.0,0,138.40999999999997,4,1,0,2.469999999999999,4,1,0,2.1422541580441994
TOWWAPM,2023-07-16,Deep Space,Lemmings 1,15,9,515.4814780292847,1.0,0,190.08000000000004,6,1,0,2.36,6,1,0,3.108804470298711
TOWWAPM,2023-07-16,Deep Space,Lemmings 2,13,8,496.1596377856195,1.0,0,487.23,5,1,0,4.83,5,1,0,6.577230973981127
TOWWAPM,2023-07-16,Exe and the City,SMOG 2,14,9,473.8676990361691,1.0,0,288.72,5,1,0,3.3,5,1,0,4.081773057403893
TOWWAPM,2023-07-16,GB Mixed Masters,Glasgow Mixed,10,8,262.66557693448596,0.9733285267845752,0,43.06,2,1,0,1.5899999999999999,2,1,0,1.2086241714297543
TOWWAPM,2023-07-16,GB Mixed Masters,Thundering Herd,14,8,536.0348119187572,1.0,0,283.03,6,1,0,4.4399999999999995,6,1,0,4.544052057718549
TOWWAPM,2023-07-16,Glasgow Mixed,Big Fish Little Fish,13,6,600.0,1.0,0,352.88,7,1,0,4.16,7,1,0,4.613423819346615
TOWWAPM,2023-07-16,LLLeeds 1,Bristol Mixed,13,5,600.0,1.0,0,233.51000000000005,8,1,0,4.49,8,1,0,4.871276509375335
TOWWAPM,2023-07-16,LLLeeds 1,Newcastle Brown,11,10,125.0,1.0,0,31.78000000000003,1,1,0,2.75,1,1,0,2.574513283067329
TOWWAPM,2023-07-16,LLLeeds 1,Zoo 1,14,2,600.0,1.0,0,349.28000000000003,12,1,0,5.2700000000000005,12,1,0,5.644599566703192
TOWWAPM,2023-07-16,Lemmings 1,Exe and the City,12,9,345.3654772346762,1.0,0,34.06999999999999,3,1,0,0.18999999999999995,3,1,0,0.2617234353924669
TOWWAPM,2023-07-16,Lemmings 1,Oxford Ultimate,13,6,600.0,1.0,0,434.28000000000003,7,1,0,4.74,7,1,0,5.907765833162795
TOWWAPM,2023-07-16,Lemmings 2,Oxford Ultimate,12,6,579.3107485100336,0.9733285267845752,0,137.13,6,1,0,2.27,6,1,0,2.3255929333063783
TOWWAPM,2023-07-16,Mixed Feelings,BN1,14,8,536.0348119187572,1.0,0,-241.9,6,1,0,-3.1100000000000003,6,1,0,-3.630742240934481
TOWWAPM,2023-07-16,Nemesis,Black Sheep Mixed,15,4,600.0,1.0,0,462.36,11,1,0,6.16,11,1,0,6.5086062794385064
TOWWAPM,2023-07-16,Nemesis,Brixton,14,6,600.0,1.0,0,433.78,8,1,0,5.82,8,1,0,6.37096164700878
TOWWAPM,2023-07-16,Nemesis,Red Mixed,15,6,600.0,1.0,0,368.99,9,1,0,6.66,9,1,0,7.034560313916593
TOWWAPM,2023-07-16,Newcastle Brown,Bristol Mixed,9,6,418.5661446562001,0.8885233166386386,0,201.73000000000002,3,1,0,1.7400000000000002,3,1,0,2.43233814467402
TOWWAPM,2023-07-16,Newcastle Brown,Zoo 1,13,7,557.5316737222639,1.0,0,317.5,6,1,0,2.5200000000000005,6,1,0,3.282065353123066
TOWWAPM,2023-07-16,Purple Cobras,Flyght Mixed,11,9,249.2068104043629,1.0,0,175.31,2,1,0,2.2800000000000002,2,1,0,2.4637291537618893
TOWWAPM,2023-07-16,Purple Cobras,Mixed Feelings,12,10,238.1225775586291,1.0,0,20.25999999999999,2,1,0,0.23000000000000043,2,1,0,0.027749968341918674
TOWWAPM,2023-07-16,Reading 2,Purple Cobras,10,5,573.8977938505714,0.8885233166386386,0,120.48000000000002,5,1,0,1.79,5,1,0,2.1040355231638372
TOWWAPM,2023-07-16,Reading 2,Sheffield Steal,15,10,453.6039151898044,1.0,0,407.59999999999997,5,1,0,5.29,5,1,0,5.999383467494287
TOWWAPM,2023-07-16,Red Mixed,Cambridge Ultimate 2,14,10,398.70186369942724,1.0,0,233.54999999999995,4,1,0,2.1899999999999995,4,1,0,2.020151610509906
TOWWAPM,2023-07-16,Red Mixed,Curve,13,12,125.0,1.0,0,95.13999999999999,1,1,0,-0.27999999999999936,1,1,0,-0.12449714114377564
TOWWAPM,2023-07-16,SLAB,Contested 1st,15,6,600.0,1.0,0,295.95,9,1,0,6.01,9,1,0,6.944727148344484
TOWWAPM,2023-07-16,SLAB,Mixed Feelings,15,7,600.0,1.0,0,410.65,8,1,0,7.53,8,1,0,7.941419394016226
TOWWAPM,2023-07-16,SLAB,Reading 2,12,10,238.1225775586291,1.0,0,269.90999999999997,2,1,0,5.51,2,1,0,6.28279289232302
TOWWAPM,2023-07-16,SMOG 1,Cambridge Ultimate,15,8,564.8086448756737,1.0,0,421.98,7,1,0,5.550000000000001,7,1,0,6.338961834788414
TOWWAPM,2023-07-16,SMOG 1,Deep Space,10,8,262.66557693448596,0.9733285267845752,0,-132.03000000000003,2,1,0,-1.0699999999999994,2,1,0,-1.7625699875654153
TOWWAPM,2023-07-16,SMOG 1,Exe and the City,12,10,238.1225775586291,1.0,0,92.12,2,1,0,1.4800000000000004,2,1,0,1.638930920979174
TOWWAPM,2023-07-16,SMOG 2,Oxford Ultimate,13,6,600.0,1.0,0,111.49000000000001,7,1,0,1.25,7,1,0,1.7877128535219633
TOWWAPM,2023-07-16,Sheffield Steal,Flyght Mixed,11,10,125.0,1.0,0,-111.80999999999995,1,1,0,-1.2199999999999998,1,1,0,-1.7418565478784291
TOWWAPM,2023-07-16,Thundering Herd,Big Fish Little Fish,11,10,125.0,1.0,0,112.91000000000003,1,1,0,1.31,1,1,0,1.2845956310260824
Regionals North,2023-07-29,Flyght Mixed,Birmingham Ultimate,10,8,262.66557693448596,0.9733285267845752,0,256.5,2,1,0,2.5599999999999996,2,1,0,3.101625882510554
Regionals North,2023-07-29,Glasgow Mixed,Birmingham Ultimate,15,6,600.0,1.0,1,862.15,9,1,0,10.209999999999999,9,1,0,10.121147612278286
Regionals North,2023-07-29,Glasgow Mixed,Flyght Mixed,13,5,600.0,1.0,1,605.65,8,1,0,7.65,8,1,0,8.157682009366866
Regionals North,2023-07-29,Lemmings 1,Birmingham Ultimate,15,6,600.0,1.0,1,1154.73,9,1,0,13.28,9,1,0,11.943852423470496
Regionals North,2023-07-29,Lemmings 1,Flyght Mixed,14,3,600.0,1.0,1,898.23,11,1,0,10.72,11,1,0,10.585005993531915
Regionals North,2023-07-29,Lemmings 1,Glasgow Mixed,12,3,600.0,0.9459053029269173,0,292.58000000000004,9,1,0,3.07,9,1,0,3.939014802619525
Regionals North,2023-07-29,Nemesis,Black Sheep Mixed,15,4,600.0,1.0,0,462.36,11,1,0,6.16,11,1,0,6.5086062794385064
Regionals North,2023-07-29,SMOG 1,Black Sheep Mixed,15,3,600.0,1.0,1,1287.52,12,1,0,16.14,12,1,0,12.965459187978588
Regionals North,2023-07-29,SMOG 1,Nemesis,15,3,600.0,1.0,1,825.1600000000001,12,1,0,9.98,12,1,0,10.331851380845585
Regionals North,2023-07-29,SMOG 1,SMOG 2,15,2,600.0,1.0,0,380.84000000000003,13,1,0,4.78,13,1,0,5.555525991313903
Regionals North,2023-07-29,SMOG 2,Black Sheep Mixed,15,2,600.0,1.0,1,906.6800000000001,13,1,0,11.36,13,1,0,10.899093778764488
Regionals North,2023-07-29,SMOG 2,Nemesis,12,7,520.5112660164395,1.0,0,444.32,5,1,0,5.2,5,1,0,6.412088065832844
Regionals South,2023-07-29,BN1,Guildford,13,3,600.0,1.0,1,826.11,10,1,0,10.530000000000001,10,1,0,10.400806642320926
Regionals South,2023-07-29,BN1,Thundering Herd,7,3,600.0,0.7254762501100116,0,31.27000000000001,4,1,0,0.3599999999999999,4,1,0,0.4985662814788707
Regionals South,2023-07-29,BN1,Zoo 1,10,8,262.66557693448596,0.9733285267845752,0,508.18000000000006,2,1,0,6.28,2,1,0,7.302481808379362
Regionals South,2023-07-29,Bristol Mixed,Brixton,8,7,125.0,0.8885233166386386,0,307.19999999999993,1,1,0,3.45,1,1,0,3.8998824212080727
Regionals South,2023-07-29,Deep Space,BN1,13,1,600.0,1.0,1,691.36,12,1,0,7.92,12,1,0,8.85277596632423
Regionals South,2023-07-29,Deep Space,Guildford,13,0,600.0,1.0,1,1517.47,13,1,0,18.45,13,1,0,13.66251603922391
Regionals South,2023-07-29,Deep Space,Thundering Herd,13,5,600.0,1.0,1,722.6300000000001,8,1,0,8.28,8,1,0,9.171431549913159
Regionals South,2023-07-29,Deep Space,Zoo 1,13,6,600.0,1.0,0,1199.54,7,1,0,14.2,7,1,0,12.549517324718735
Regionals South,2023-07-29,Oxford Ultimate,Bristol Mixed,12,3,600.0,0.9459053029269173,0,459.41,9,1,0,6.32,9,1,0,7.21633199022331
Regionals South,2023-07-29,Oxford Ultimate,Brixton,13,3,600.0,1.0,1,766.61,10,1,0,9.77,10,1,0,9.880382872293914
Regionals South,2023-07-29,Oxford Ultimate,Purple Cobras,11,7,466.89332573293274,0.9733285267845752,0,288.64,4,1,0,3.7,4,1,0,4.320220125079636
Regionals South,2023-07-29,Purple Cobras,Bristol Mixed,8,6,300.4922431832018,0.8583950752789521,0,170.77000000000004,2,1,0,2.62,2,1,0,3.361945111981843
Regionals South,2023-07-29,Purple Cobras,Brixton,13,3,600.0,1.0,0,477.96999999999997,10,1,0,6.07,10,1,0,6.86196726224221
Regionals South,2023-07-29,Reading,Bristol Mixed,13,6,600.0,1.0,0,1109.0,7,1,0,13.440000000000001,7,1,0,12.41319277017331
Regionals South,2023-07-29,Reading,Brixton,13,2,600.0,1.0,1,1416.1999999999998,11,1,0,16.89,11,1,0,13.4246809617798
Regionals South,2023-07-29,Reading,Oxford Ultimate,13,7,557.5316737222639,1.0,0,649.5899999999999,6,1,0,7.12,6,1,0,8.634426153882476
Regionals South,2023-07-29,Reading,Purple Cobras,13,4,600.0,1.0,1,938.23,9,1,0,10.82,9,1,0,11.112338087048919
Regionals South,2023-07-29,Thundering Herd,Guildford,13,2,600.0,1.0,1,794.8399999999999,11,1,0,10.17,11,1,0,10.135837239828092
Regionals South,2023-07-29,Thundering Herd,Zoo 1,10,8,262.66557693448596,0.9733285267845752,0,476.91,2,1,0,5.92,2,1,0,6.915821860497651
Regionals South,2023-07-29,Zoo 1,Guildford,11,2,600.0,0.9176629354822471,0,317.92999999999995,9,1,0,4.25,9,1,0,4.6771623272986105
Regionals North,2023-07-30,Birmingham Ultimate,Black Sheep Mixed,11,9,249.2068104043629,1.0,0,74.74000000000001,2,1,0,1.5700000000000003,2,1,0,1.936138812063497
Regionals North,2023-07-30,Flyght Mixed,Black Sheep Mixed,12,6,579.3107485100336,0.9733285267845752,0,331.24,6,1,0,4.13,6,1,0,4.906803669329285
Regionals North,2023-07-30,Glasgow Mixed,SMOG 2,11,10,125.0,1.0,0,30.209999999999994,1,1,0,0.42,1,1,0,0.4153937629407345
Regionals North,2023-07-30,Lemmings 1,SMOG 2,12,8,441.15462425988915,1.0,0,322.79,4,1,0,3.4899999999999998,4,1,0,4.322971109219139
Regionals North,2023-07-30,Nemesis,Birmingham Ultimate,10,8,262.66557693448596,0.9733285267845752,0,387.62,2,1,0,4.59,2,1,0,4.843751232318333
Regionals North,2023-07-30,Nemesis,Flyght Mixed,14,5,600.0,1.0,0,131.12,9,1,0,2.0300000000000002,9,1,0,1.8667718127011668
Regionals North,2023-07-30,SMOG 1,Glasgow Mixed,15,4,600.0,1.0,0,350.63,11,1,0,4.36,11,1,0,5.193398746085524
Regionals North,2023-07-30,SMOG 1,Lemmings 1,11,6,546.6949863040446,0.9459053029269173,0,58.05000000000001,5,1,0,1.2900000000000005,5,1,0,1.3798380495097113
Regionals South,2023-07-30,BN1,Purple Cobras,15,4,600.0,1.0,0,221.64000000000001,11,1,0,2.88,11,1,0,3.6046063830054607
Regionals South,2023-07-30,BN1,Thundering Herd,14,7,582.8868714046324,1.0,0,31.27000000000001,7,1,0,0.3599999999999999,7,1,0,0.4985662814788707
Regionals South,2023-07-30,Bristol Mixed,Guildford,13,5,600.0,1.0,0,433.69999999999993,8,1,0,5.03,8,1,0,5.4581893728318
Regionals South,2023-07-30,Brixton,Guildford,10,9,125.0,1.0,0,126.5,1,1,0,1.58,1,1,0,1.7211363721971793
Regionals South,2023-07-30,Deep Space,Thundering Herd,15,7,600.0,1.0,0,722.6300000000001,8,1,0,8.28,8,1,0,9.171431549913159
Regionals South,2023-07-30,Oxford Ultimate,Bristol Mixed,15,1,600.0,1.0,0,459.41,14,1,0,6.32,14,1,0,7.21633199022331
Regionals South,2023-07-30,Oxford Ultimate,Zoo 1,14,9,473.8676990361691,1.0,0,575.1800000000001,5,1,0,7.1000000000000005,5,1,0,7.874810474563088
Regionals South,2023-07-30,Purple Cobras,Bristol Mixed,9,4,600.0,0.8271701918685112,0,170.77000000000004,5,1,0,2.62,5,1,0,3.361945111981843
Regionals South,2023-07-30,Reading,BN1,15,8,564.8086448756737,1.0,0,716.5899999999999,7,1,0,7.94,7,1,0,9.133770350656317
Regionals South,2023-07-30,Reading,Deep Space,14,11,313.3379659704299,1.0,0,25.229999999999905,3,1,0,0.020000000000000462,3,1,0,0.4386249167908023
Regionals South,2023-07-30,Thundering Herd,Oxford Ultimate,10,6,496.1596377856195,0.9176629354822471,0,-98.27,4,1,0,-1.18,4,1,0,-1.2652365027629742
Regionals South,2023-07-30,Zoo 1,Brixton,7,5,328.14240231865136,0.7947194142390263,0,191.42999999999995,2,1,0,2.67,2,1,0,3.0657107386296083
Regionals South,2023-07-30,Zoo 1,Purple Cobras,8,7,125.0,0.8885233166386386,0,-286.54,1,1,0,-3.4000000000000004,1,1,0,-4.187803221225904
Nationals,2023-08-27,BN1,Flyght Mixed,15,10,453.6039151898044,1.0,0,396.95000000000005,5,1,0,5.16,5,1,0,5.837912511542353
Nationals,2023-08-27,Deep Space,BN1,15,5,600.0,1.0,1,691.36,10,1,0,7.92,10,1,0,8.85277596632423
Nationals,2023-08-27,Deep Space,Flyght Mixed,15,2,600.0,1.0,1,1088.31,13,1,0,13.08,13,1,0,11.946596143865015
Nationals,2023-08-27,Deep Space,Glasgow Mixed,15,5,600.0,1.0,0,482.6600000000001,10,1,0,5.43,10,1,0,6.684040324010834
Nationals,2023-08-27,Glasgow Mixed,Zoo 1,15,6,600.0,1.0,1,716.88,9,1,0,8.77,9,1,0,9.35194277627389
Nationals,2023-08-27,Lemmings 1,BN1,15,5,600.0,1.0,0,501.28,10,1,0,5.5600000000000005,10,1,0,6.544479072651949
Nationals,2023-08-27,Lemmings 1,Glasgow Mixed,12,7,520.5112660164395,1.0,0,292.58000000000004,5,1,0,3.07,5,1,0,3.939014802619525
Nationals,2023-08-27,Lemmings 1,Zoo 1,15,2,600.0,1.0,1,1009.46,13,1,0,11.84,13,1,0,11.421076540844595
Nationals,2023-08-27,Nemesis,Zoo 1,12,11,125.0,1.0,0,242.35000000000002,1,1,0,3.1500000000000004,1,1,0,3.619443110811151
Nationals,2023-08-27,Oxford Ultimate,Flyght Mixed,13,8,496.1596377856195,1.0,0,463.95,5,1,0,5.98,5,1,0,6.477523487318038
Nationals,2023-08-27,Reading,Nemesis,15,6,600.0,1.0,1,982.42,9,1,0,11.07,9,1,0,11.37926104902822
Nationals,2023-08-27,Reading,SMOG 2,15,6,600.0,1.0,0,538.0999999999999,9,1,0,5.87,9,1,0,7.351021983240823
Nationals,2023-08-27,Reading,Thundering Herd,15,5,600.0,1.0,1,747.8599999999999,10,1,0,8.3,10,1,0,9.44125445713361
Nationals,2023-08-27,SMOG 1,Oxford Ultimate,15,7,600.0,1.0,0,492.33000000000004,8,1,0,6.03,8,1,0,7.032805040842117
Nationals,2023-08-27,SMOG 1,SMOG 2,15,9,515.4814780292847,1.0,0,380.84000000000003,6,1,0,4.78,6,1,0,5.555525991313903
Nationals,2023-08-27,SMOG 1,Thundering Herd,15,6,600.0,1.0,0,590.6,9,1,0,7.210000000000001,9,1,0,7.982360075446593
Nationals,2023-08-27,SMOG 2,Oxford Ultimate,13,7,557.5316737222639,1.0,0,111.49000000000001,6,1,0,1.25,6,1,0,1.7877128535219633
Nationals,2023-08-27,Thundering Herd,Nemesis,14,9,473.8676990361691,1.0,0,234.56,5,1,0,2.77,5,1,0,3.7090088489467803
Nationals,2023-08-28,BN1,Thundering Herd,10,9,125.0,1.0,0,31.27000000000001,1,1,0,0.3599999999999999,1,1,0,0.4985662814788707
Nationals,2023-08-28,Deep Space,Lemmings 1,12,7,520.5112660164395,1.0,0,190.08000000000004,5,1,0,2.36,5,1,0,3.108804470298711
Nationals,2023-08-28,Deep Space,Reading,12,8,441.15462425988915,1.0,0,-25.229999999999905,4,1,0,-0.020000000000000462,4,1,0,-0.4386249167908023
Nationals,2023-08-28,Flyght Mixed,Zoo 1,13,5,600.0,1.0,0,111.23000000000002,8,1,0,1.12,8,1,0,1.8069328853421496
Nationals,2023-08-28,Glasgow Mixed,BN1,14,8,536.0348119187572,1.0,0,208.7,6,1,0,2.49,6,1,0,2.9426058099661
Nationals,2023-08-28,Glasgow Mixed,SMOG 2,15,7,600.0,1.0,0,30.209999999999994,8,1,0,0.42,8,1,0,0.4153937629407345
Nationals,2023-08-28,Lemmings 1,SMOG 1,15,9,515.4814780292847,1.0,0,-58.05000000000001,6,1,0,-1.2900000000000005,6,1,0,-1.3798380495097131
Nationals,2023-08-28,Nemesis,Flyght Mixed,10,7,389.6652919127421,0.9459053029269173,0,131.12,3,1,0,2.0300000000000002,3,1,0,1.8667718127011668
Nationals,2023-08-28,Oxford Ultimate,Nemesis,15,6,600.0,1.0,0,332.83,9,1,0,3.95,9,1,0,4.872618270231403
Nationals,2023-08-28,Oxford Ultimate,Zoo 1,13,8,496.1596377856195,1.0,0,575.1800000000001,5,1,0,7.1000000000000005,5,1,0,7.874810474563088
Nationals,2023-08-28,SMOG 1,Reading,14,11,313.3379659704299,1.0,0,-157.25999999999993,3,1,0,-1.0899999999999999,3,1,0,-2.193657428073479
Nationals,2023-08-28,SMOG 2,Thundering Herd,15,6,600.0,1.0,0,209.76,9,1,0,2.43,9,1,0,3.0225641295313785
