Tournament,Date,Team_1,Team_2,Score_1,Score_2,Game_Rank_Diff_USAU,Game_Wght_USAU,Is_Ignored_USAU,Team_Rank_Diff_USAU,Game_Rank_Diff_Windmill,Game_Wght_Windmill,Is_Ignored_Windmill,Team_Rank_Diff_Windmill,Game_Rank_Diff_Sigmoid,Game_Wght_Sigmoid,Is_Ignored_Sigmoid,Team_Rank_Diff_Sigmoid
Spring Invite Padova,2023-04-21,3SB - Women @ Spring Invite Padova,Catchup Women @ Spring Invite Padova,13,10,328.14240231865136,1.0,0,341.09,3,1,0,3.8299999999999996,3,1,0,3.8998824212080727
Spring Invite Padova,2023-04-21,3SB - Women @ Spring Invite Padova,Cheetahs @ Spring Invite Padova,15,8,564.8086448756737,1.0,0,582.49,7,1,0,7.0,7,1,0,6.839411986728866
Spring Invite Padova,2023-04-21,3SB - Women @ Spring Invite Padova,Panthers Wroclaw - Women @ Spring Invite Padova,14,13,125.0,1.0,0,69.21000000000001,1,1,0,0.8900000000000001,1,1,0,0.8757529189193303
Spring Invite Padova,2023-04-21,CUS Padova Tane Malefiche @ Spring Invite Padova,Catchup Women @ Spring Invite Padova,15,8,564.8086448756737,1.0,0,668.0,7,1,0,7.22,7,1,0,7.198449799579397
Spring Invite Padova,2023-04-21,CUS Padova Tane Malefiche @ Spring Invite Padova,DiscoBolo @ Spring Invite Padova,12,8,441.15462425988915,1.0,0,412.15999999999997,4,1,0,5.11,4,1,0,5.3603200287831605
Spring Invite Padova,2023-04-21,CUS Padova Tane Malefiche @ Spring Invite Padova,East Block @ Spring Invite Padova,15,13,214.17926913507503,1.0,0,-109.77000000000001,2,1,0,-1.8899999999999997,2,1,0,-1.9235998619432184
Spring Invite Padova,2023-04-21,CUS Padova Tane Malefiche @ Spring Invite Padova,box vienna @ Spring Invite Padova,15,9,515.4814780292847,1.0,0,154.53,6,1,0,2.5,6,1,0,2.5941621876796646
Spring Invite Padova,2023-04-21,Catchup Women @ Spring Invite Padova,Cheetahs @ Spring Invite Padova,14,11,313.3379659704299,1.0,0,241.40000000000003,3,1,0,3.170000000000001,3,1,0,3.3348652848800846
Spring Invite Padova,2023-04-21,DiscoBolo @ Spring Invite Padova,Cheetahs @ Spring Invite Padova,10,6,496.1596377856195,0.9176629354822471,0,497.24,4,1,0,5.28,4,1,0,5.376668298371111
Spring Invite Padova,2023-04-21,East Block @ Spring Invite Padova,DiscoBolo @ Spring Invite Padova,15,10,453.6039151898044,1.0,0,521.9300000000001,5,1,0,7.0,5,1,0,6.964745393333281
Spring Invite Padova,2023-04-21,East Block @ Spring Invite Padova,Tequila Boom Boom @ Spring Invite Padova,15,9,515.4814780292847,1.0,0,314.38,6,1,0,3.8499999999999996,6,1,0,4.052588945076145
Spring Invite Padova,2023-04-21,East Block @ Spring Invite Padova,box vienna @ Spring Invite Padova,15,5,600.0,1.0,0,264.3,10,1,0,4.39,10,1,0,4.4197394951248015
Spring Invite Padova,2023-04-21,Panthers Wroclaw - Women @ Spring Invite Padova,Catchup Women @ Spring Invite Padova,15,10,453.6039151898044,1.0,0,271.88,5,1,0,2.9399999999999995,5,1,0,3.070741078333217
Spring Invite Padova,2023-04-21,Panthers Wroclaw - Women @ Spring Invite Padova,Catchup Women @ Spring Invite Padova,12,8,441.15462425988915,1.0,0,271.88,4,1,0,2.9399999999999995,4,1,0,3.070741078333217
Spring Invite Padova,2023-04-21,Panthers Wroclaw - Women @ Spring Invite Padova,Cheetahs @ Spring Invite Padova,15,8,564.8086448756737,1.0,0,513.28,7,1,0,6.11,7,1,0,6.126757015929211
Spring Invite Padova,2023-04-21,Shout @ Spring Invite Padova,3SB - Women @ Spring Invite Padova,15,11,381.1647521399218,1.0,0,617.52,4,1,0,6.8500000000000005,4,1,0,6.957683734010068
Spring Invite Padova,2023-04-21,Shout @ Spring Invite Padova,CUS Padova Tane Malefiche @ Spring Invite Padova,11,8,365.60925011032475,1.0,0,290.61,3,1,0,3.46,3,1,0,3.6095527924059887
Spring Invite Padova,2023-04-21,Shout @ Spring Invite Padova,DiscoBolo @ Spring Invite Padova,15,6,600.0,1.0,0,702.77,9,1,0,8.57,9,1,0,8.259606899873805
Spring Invite Padova,2023-04-21,Shout @ Spring Invite Padova,East Block @ Spring Invite Padova,15,14,125.0,1.0,0,180.83999999999997,1,1,0,1.5700000000000003,1,1,0,1.7396368498734525
Spring Invite Padova,2023-04-21,Shout @ Spring Invite Padova,East Block @ Spring Invite Padova,15,11,381.1647521399218,1.0,0,180.83999999999997,4,1,0,1.5700000000000003,4,1,0,1.7396368498734525
Spring Invite Padova,2023-04-21,Shout @ Spring Invite Padova,box vienna @ Spring Invite Padova,15,8,564.8086448756737,1.0,0,445.14,7,1,0,5.96,7,1,0,5.9558518712335164
Spring Invite Padova,2023-04-21,Tequila Boom Boom @ Spring Invite Padova,3SB - Women @ Spring Invite Padova,15,11,381.1647521399218,1.0,0,122.3,4,1,0,1.43,4,1,0,1.6233671677641652
Spring Invite Padova,2023-04-21,Tequila Boom Boom @ Spring Invite Padova,3SB - Women @ Spring Invite Padova,13,12,125.0,1.0,0,122.3,1,1,0,1.43,1,1,0,1.6233671677641652
Spring Invite Padova,2023-04-21,Tequila Boom Boom @ Spring Invite Padova,Catchup Women @ Spring Invite Padova,15,12,300.4922431832018,1.0,0,463.39,3,1,0,5.26,3,1,0,5.372092257581169
Spring Invite Padova,2023-04-21,Tequila Boom Boom @ Spring Invite Padova,Cheetahs @ Spring Invite Padova,15,6,600.0,1.0,0,704.79,9,1,0,8.43,9,1,0,8.06481197957222
Spring Invite Padova,2023-04-21,Tequila Boom Boom @ Spring Invite Padova,Panthers Wroclaw - Women @ Spring Invite Padova,14,10,398.70186369942724,1.0,0,191.51,4,1,0,2.3200000000000003,4,1,0,2.483428477231893
Spring Invite Padova,2023-04-21,box vienna @ Spring Invite Padova,CUS Padova Tane Malefiche @ Spring Invite Padova,15,11,381.1647521399218,1.0,0,-154.53,4,1,0,-2.5,4,1,0,-2.5941621876796663
Spring Invite Padova,2023-04-21,box vienna @ Spring Invite Padova,DiscoBolo @ Spring Invite Padova,14,10,398.70186369942724,1.0,0,257.63,4,1,0,2.6100000000000003,4,1,0,2.948374452223959
Spring Invite Padova,2023-04-21,box vienna @ Spring Invite Padova,Panthers Wroclaw - Women @ Spring Invite Padova,15,11,381.1647521399218,1.0,0,241.59,4,1,0,1.78,4,1,0,2.0937411057761928
Spring Invite,2023-04-22,Bristol,Horizon,15,2,600.0,1.0,0,510.72,13,1,0,5.9399999999999995,13,1,0,6.906369234211635
Spring Invite,2023-04-22,Bristol,SMOG Women,14,8,536.0348119187572,1.0,0,92.5,6,1,0,1.21,6,1,0,1.4905644879800128
Spring Invite,2023-04-22,Bristol,SYC,14,8,536.0348119187572,1.0,0,154.0,6,1,0,2.15,6,1,0,2.618165051971392
Spring Invite,2023-04-22,Brixton,Chameleons,12,3,600.0,0.9459053029269173,0,519.7299999999999,9,1,0,5.460000000000001,9,1,0,7.201912947299263
Spring Invite,2023-04-22,Brixton,Oxford Ultimate,9,7,279.3368557106305,0.9176629354822471,0,292.13,2,1,0,3.6900000000000013,2,1,0,4.280295321813618
Spring Invite,2023-04-22,Dublin Gravity,Brighton Ultimate,15,6,600.0,1.0,1,706.1700000000001,9,1,0,11.270000000000001,9,1,0,11.909648322288351
Spring Invite,2023-04-22,Dublin Gravity,SCRAM,13,5,600.0,1.0,0,304.36999999999995,8,1,0,4.12,8,1,0,4.376551713845341
Spring Invite,2023-04-22,Dublin Gravity,Spice Ultimate,15,6,600.0,1.0,0,-86.38,9,1,0,-0.81,9,1,0,-0.6708022852678983
Spring Invite,2023-04-22,GB U20 Women,Brixton,9,6,418.5661446562001,0.8885233166386386,0,64.28999999999996,3,1,0,1.3699999999999992,3,1,0,1.44599569165187
Spring Invite,2023-04-22,GB U20 Women,Brixton,9,6,418.5661446562001,0.8885233166386386,0,64.28999999999996,3,1,0,1.3699999999999992,3,1,0,1.44599569165187
Spring Invite,2023-04-22,GB U20 Women,Chameleons,10,4,600.0,0.8583950752789521,0,584.0199999999999,6,1,0,6.83,6,1,0,8.265353718298943
Spring Invite,2023-04-22,GB U20 Women,Chameleons,13,0,600.0,1.0,0,584.0199999999999,13,1,0,6.83,13,1,0,8.265353718298943
Spring Invite,2023-04-22,GB U20 Women,GB U20 Women,1,1,0.0,0.3244428422615251,0,0.0,0,1,0,0.0,0,1,0,0.0
Spring Invite,2023-04-22,GB U20 Women,Oxford Ultimate,8,6,300.4922431832018,0.8583950752789521,0,356.41999999999996,2,1,0,5.0600000000000005,2,1,0,5.572989500782942
Spring Invite,2023-04-22,GB U20 Women,Oxford Ultimate,11,3,600.0,0.9176629354822471,0,356.41999999999996,8,1,0,5.0600000000000005,8,1,0,5.572989500782942
Spring Invite,2023-04-22,Iceni,Reading 1,15,11,381.1647521399218,1.0,0,183.15999999999997,4,1,0,1.65,4,1,0,2.0348775548566174
Spring Invite,2023-04-22,Iceni,SYC,15,5,600.0,1.0,0,302.65999999999997,10,1,0,3.82,10,1,0,4.483346317614302
Spring Invite,2023-04-22,LMU,Iceni,15,8,564.8086448756737,1.0,0,-0.3199999999999932,7,1,0,0.41000000000000014,7,1,0,0.4596060875794592
Spring Invite,2023-04-22,LMU,SYC,15,6,600.0,1.0,0,302.34,9,1,0,4.23,9,1,0,4.898095143508733
Spring Invite,2023-04-22,Oxford Ultimate,Chameleons,8,5,453.6039151898044,0.8271701918685112,0,227.5999999999999,3,1,0,1.7699999999999996,3,1,0,3.385443106527987
Spring Invite,2023-04-22,Reading 1,LMU,15,12,300.4922431832018,1.0,0,-182.83999999999997,3,1,0,-2.06,3,1,0,-2.484157913136274
Spring Invite,2023-04-22,Reading 1,SYC,15,6,600.0,1.0,0,119.5,9,1,0,2.17,9,1,0,2.551942202083012
Spring Invite,2023-04-22,SCRAM,Brighton Ultimate,15,6,600.0,1.0,0,401.80000000000007,9,1,0,7.15,9,1,0,9.804361581603953
Spring Invite,2023-04-22,SMOG Women,Horizon,14,8,536.0348119187572,1.0,0,418.22,6,1,0,4.7299999999999995,6,1,0,5.67547378312759
Spring Invite,2023-04-22,SMOG Women,SYC,13,10,328.14240231865136,1.0,0,61.5,3,1,0,0.94,3,1,0,1.1475036000689833
Spring Invite,2023-04-22,SYC,Horizon,14,7,582.8868714046324,1.0,0,356.72,7,1,0,3.79,7,1,0,4.662938985104578
Spring Invite,2023-04-22,Spice Ultimate,Brighton Ultimate,15,1,600.0,1.0,1,792.5500000000001,14,1,0,12.08,14,1,0,12.149076360194506
Spring Invite,2023-04-22,Spice Ultimate,SCRAM,15,6,600.0,1.0,0,390.75,9,1,0,4.93,9,1,0,4.982344350295179
Spring Invite,2023-04-23,Brighton Ultimate,GB U20 Women,13,7,557.5316737222639,1.0,0,-151.99,6,1,0,-2.9000000000000004,6,1,0,-3.2227420662092374
Spring Invite,2023-04-23,Brighton Ultimate,Oxford Ultimate,15,6,600.0,1.0,0,204.42999999999995,9,1,0,2.16,9,1,0,2.5541270222212518
Spring Invite,2023-04-23,Bristol,Reading 1,15,10,453.6039151898044,1.0,0,34.5,5,1,0,-0.020000000000000018,5,1,0,0.06824952902202597
Spring Invite,2023-04-23,Bristol,Spice Ultimate,14,10,398.70186369942724,1.0,0,33.650000000000006,4,1,0,0.44999999999999996,4,1,0,0.7508718731293538
Spring Invite,2023-04-23,Brixton,Brighton Ultimate,12,5,600.0,0.9459053029269173,0,87.70000000000005,7,1,0,1.5300000000000011,7,1,0,1.8143236060266439
Spring Invite,2023-04-23,Dublin Gravity,Bristol,10,9,125.0,1.0,0,-120.03,1,1,0,-1.26,1,1,0,-1.418498697325294
Spring Invite,2023-04-23,Dublin Gravity,LMU,14,10,398.70186369942724,1.0,0,-268.37,4,1,0,-3.3400000000000003,4,1,0,-3.7786333354119854
Spring Invite,2023-04-23,Dublin Gravity,Reading 1,13,10,328.14240231865136,1.0,0,-85.53,3,1,0,-1.28,3,1,0,-1.3508303968102968
Spring Invite,2023-04-23,GB U20 Women,Chameleons,15,7,600.0,1.0,0,584.0199999999999,8,1,0,6.83,8,1,0,8.265353718298943
Spring Invite,2023-04-23,GB U20 Women,GB U20 Women,5,4,125.0,0.6882472016116853,0,0.0,1,1,0,0.0,1,1,0,0.0
Spring Invite,2023-04-23,Horizon,Chameleons,15,1,600.0,1.0,1,747.5099999999999,14,1,0,10.52,14,1,0,11.901878064362908
Spring Invite,2023-04-23,Horizon,GB U20 Women,15,4,600.0,1.0,0,163.49,11,1,0,3.6900000000000004,11,1,0,6.461650972574503
Spring Invite,2023-04-23,Horizon,SYC,15,12,300.4922431832018,1.0,0,-356.72,3,1,0,-3.79,3,1,0,-4.6629389851045815
Spring Invite,2023-04-23,Iceni,SCRAM,15,6,600.0,1.0,0,573.06,9,1,0,7.05,9,1,0,7.249717398899687
Spring Invite,2023-04-23,Iceni,SYC,15,3,600.0,1.0,0,302.65999999999997,12,1,0,3.82,12,1,0,4.483346317614302
Spring Invite,2023-04-23,LMU,SMOG Women,15,10,453.6039151898044,1.0,0,240.83999999999997,5,1,0,3.29,5,1,0,3.8466830855828036
Spring Invite,2023-04-23,LMU,Spice Ultimate,13,10,328.14240231865136,1.0,0,181.98999999999998,3,1,0,2.5300000000000002,3,1,0,3.1432409287486536
Spring Invite,2023-04-23,Oxford Ultimate,Chameleons,15,7,600.0,1.0,0,227.5999999999999,8,1,0,1.7699999999999996,8,1,0,3.385443106527987
Spring Invite,2023-04-23,Reading 1,SMOG Women,13,12,125.0,1.0,0,58.0,1,1,0,1.23,1,1,0,1.4229583279008189
Spring Invite,2023-04-23,SYC,Brixton,14,9,473.8676990361691,1.0,0,584.5,5,1,0,8.85,5,1,0,10.589146166674286
Spring Invite,2023-04-23,SYC,Oxford Ultimate,15,0,600.0,1.0,1,876.63,15,1,0,12.540000000000001,15,1,0,12.37631881790805
Spring Invite,2023-04-23,SYC,SCRAM,12,7,520.5112660164395,1.0,0,270.4,5,1,0,3.23,5,1,0,3.2334710320418125
Spring Invite,2023-04-23,Spice Ultimate,SMOG Women,13,10,328.14240231865136,1.0,0,58.849999999999994,3,1,0,0.7600000000000001,3,1,0,0.7433904801195457
Toms Tourney,2023-05-05,Austrian Women @ Toms Tourney,DESKEAGH @ Toms Tourney,13,12,125.0,1.0,0,-94.67,1,1,0,-0.8900000000000001,1,1,0,-1.0594828204723328
Toms Tourney,2023-05-05,Austrian Women @ Toms Tourney,GB U24 Women,11,8,365.60925011032475,1.0,0,58.559999999999995,3,1,0,0.9999999999999999,3,1,0,1.8327964892440605
Toms Tourney,2023-05-05,Austrian Women @ Toms Tourney,Spain Women @ Toms Tourney,12,8,441.15462425988915,1.0,0,257.9,4,1,0,2.52,4,1,0,3.33201344246422
Toms Tourney,2023-05-05,Belgian Women @ Toms Tourney,Austrian Women @ Toms Tourney,12,8,441.15462425988915,1.0,0,323.94,4,1,0,4.69,4,1,0,4.872618270231403
Toms Tourney,2023-05-05,Belgian Women @ Toms Tourney,Czech Women @ Toms Tourney,14,10,398.70186369942724,1.0,0,150.22999999999996,4,1,0,1.1800000000000006,4,1,0,1.0311212322634162
Toms Tourney,2023-05-05,Belgian Women @ Toms Tourney,German masters @ Toms Tourney,15,3,600.0,1.0,0,679.56,12,1,0,10.84,12,1,0,10.673128138280834
Toms Tourney,2023-05-05,Belgian Women @ Toms Tourney,LMU,14,8,536.0348119187572,1.0,0,188.94,6,1,0,2.72,6,1,0,3.314897073208737
Toms Tourney,2023-05-05,Bordeaux Ultimate @ Toms Tourney,Family Ultimate @ Toms Tourney,14,11,313.3379659704299,1.0,0,313.34,3,1,0,3.0,3,1,0,2.999531218569235
Toms Tourney,2023-05-05,Czech Women @ Toms Tourney,Crazy Dogs @ Toms Tourney,15,1,600.0,1.0,0,669.84,14,1,0,13.45,14,1,0,13.233651232726938
Toms Tourney,2023-05-05,Czech Women @ Toms Tourney,DESKEAGH @ Toms Tourney,15,4,600.0,1.0,0,79.04000000000002,11,1,0,2.6199999999999997,11,1,0,2.923851478201133
Toms Tourney,2023-05-05,Czech Women @ Toms Tourney,Germany U24 @ Toms Tourney,11,10,125.0,1.0,0,44.70000000000002,1,1,0,2.05,1,1,0,2.187785408432312
Toms Tourney,2023-05-05,DESKEAGH @ Toms Tourney,Austrian Women @ Toms Tourney,14,10,398.70186369942724,1.0,0,94.67,4,1,0,0.8900000000000001,4,1,0,1.0594828204723363
Toms Tourney,2023-05-05,DESKEAGH @ Toms Tourney,NL Women @ Toms Tourney,12,10,238.1225775586291,1.0,0,-122.19,2,1,0,-1.33,2,1,0,-1.1057405595806067
Toms Tourney,2023-05-05,DESKEAGH @ Toms Tourney,Panthers Wroclaw - Women @ Toms Tourney,11,10,125.0,1.0,0,-2.6500000000000057,1,1,0,0.33999999999999986,1,1,0,0.6940041609307634
Toms Tourney,2023-05-05,France Women @ Toms Tourney,Austrian Women @ Toms Tourney,13,10,328.14240231865136,1.0,0,360.64000000000004,3,1,0,4.76,3,1,0,5.0748775755088325
Toms Tourney,2023-05-05,France Women @ Toms Tourney,Belgian Women @ Toms Tourney,13,9,418.5661446562001,1.0,0,36.700000000000045,4,1,0,0.0699999999999994,4,1,0,0.2272326152666988
Toms Tourney,2023-05-05,France Women @ Toms Tourney,Czech Women @ Toms Tourney,12,8,441.15462425988915,1.0,0,186.93,4,1,0,1.25,4,1,0,1.2570448204186917
Toms Tourney,2023-05-05,France Women @ Toms Tourney,German masters @ Toms Tourney,15,4,600.0,1.0,0,716.26,11,1,0,10.91,11,1,0,10.784118366866021
Toms Tourney,2023-05-05,France Women @ Toms Tourney,Shout @ Toms Tourney,12,11,125.0,1.0,0,-132.04999999999995,1,1,0,-1.2300000000000004,1,1,0,-1.7869735021742432
Toms Tourney,2023-05-05,GB U24 Women,Crazy Dogs @ Toms Tourney,15,4,600.0,1.0,0,437.57,11,1,0,8.94,11,1,0,11.391024391321235
Toms Tourney,2023-05-05,GB U24 Women,Spain Women @ Toms Tourney,11,7,466.89332573293274,0.9733285267845752,0,199.34,4,1,0,1.52,4,1,0,1.541043634486229
Toms Tourney,2023-05-05,GB U24 Women,Spain Women @ Toms Tourney,11,7,466.89332573293274,0.9733285267845752,0,199.34,4,1,0,1.52,4,1,0,1.541043634486229
Toms Tourney,2023-05-05,GB Women,Austrian Women @ Toms Tourney,13,7,557.5316737222639,1.0,0,577.39,6,1,0,6.75,6,1,0,6.868489112178867
Toms Tourney,2023-05-05,GB Women,Belgian Women @ Toms Tourney,12,9,345.3654772346762,1.0,0,253.45000000000005,3,1,0,2.0599999999999996,3,1,0,2.3446203611005316
Toms Tourney,2023-05-05,GB Women,DESKEAGH @ Toms Tourney,11,8,365.60925011032475,1.0,0,482.72,3,1,0,5.859999999999999,3,1,0,6.003163161824382
Toms Tourney,2023-05-05,GB Women,DESKEAGH @ Toms Tourney,11,8,365.60925011032475,1.0,0,482.72,3,1,0,5.859999999999999,3,1,0,6.003163161824382
Toms Tourney,2023-05-05,GB Women,France Women @ Toms Tourney,12,8,441.15462425988915,1.0,0,216.75,4,1,0,1.9900000000000002,4,1,0,2.1224133774969474
Toms Tourney,2023-05-05,GB Women,NL Women @ Toms Tourney,13,11,228.8403622143806,1.0,0,360.53000000000003,2,1,0,4.529999999999999,2,1,0,5.04629829247768
Toms Tourney,2023-05-05,GB Women,Panthers Wroclaw - Women @ Toms Tourney,15,5,600.0,1.0,0,480.07000000000005,10,1,0,6.199999999999999,10,1,0,6.575413454125133
Toms Tourney,2023-05-05,GB Women,Shout @ Toms Tourney,15,12,300.4922431832018,1.0,0,84.70000000000005,3,1,0,0.7599999999999998,3,1,0,0.34119113945120105
Toms Tourney,2023-05-05,German masters @ Toms Tourney,Crazy Dogs @ Toms Tourney,15,3,600.0,1.0,0,140.51000000000002,12,1,0,3.789999999999999,12,1,0,7.667967267453072
Toms Tourney,2023-05-05,Germany U24 @ Toms Tourney,Crazy Dogs @ Toms Tourney,15,6,600.0,1.0,0,625.14,9,1,0,11.399999999999999,9,1,0,12.677123677465922
Toms Tourney,2023-05-05,Germany U24 @ Toms Tourney,Crazy Dogs @ Toms Tourney,15,6,600.0,1.0,0,625.14,9,1,0,11.399999999999999,9,1,0,12.677123677465922
Toms Tourney,2023-05-05,Germany U24 @ Toms Tourney,GB U24 Women,15,6,600.0,1.0,0,187.57,9,1,0,2.46,9,1,0,3.5904692029316436
Toms Tourney,2023-05-05,Germany U24 @ Toms Tourney,German masters @ Toms Tourney,15,7,600.0,1.0,0,484.63,8,1,0,7.61,8,1,0,8.819473507887025
Toms Tourney,2023-05-05,Helgtre @ Toms Tourney,AUC @ Toms Tourney,15,13,214.17926913507503,1.0,0,214.18,2,1,0,2.0,2,1,0,1.9995286300752646
Toms Tourney,2023-05-05,JinX @ Toms Tourney,Austrian Women @ Toms Tourney,14,6,600.0,1.0,0,429.50000000000006,8,1,0,5.2700000000000005,8,1,0,5.558761293865711
Toms Tourney,2023-05-05,JinX @ Toms Tourney,Austrian Women @ Toms Tourney,14,6,600.0,1.0,0,429.50000000000006,8,1,0,5.2700000000000005,8,1,0,5.558761293865711
Toms Tourney,2023-05-05,JinX @ Toms Tourney,Czech Women @ Toms Tourney,10,9,125.0,1.0,0,255.79000000000002,1,1,0,1.7600000000000007,1,1,0,1.8047154953565503
Toms Tourney,2023-05-05,JinX @ Toms Tourney,DESKEAGH @ Toms Tourney,15,8,564.8086448756737,1.0,0,334.83000000000004,7,1,0,4.380000000000001,7,1,0,4.620213318708323
Toms Tourney,2023-05-05,JinX @ Toms Tourney,France Women @ Toms Tourney,12,11,125.0,1.0,0,68.86000000000001,1,1,0,0.5100000000000007,1,1,0,0.5532489197034902
Toms Tourney,2023-05-05,JinX @ Toms Tourney,GB U24 Women,13,10,328.14240231865136,1.0,0,488.06000000000006,3,1,0,6.2700000000000005,3,1,0,7.071363965561943
Toms Tourney,2023-05-05,JinX @ Toms Tourney,GB Women,12,10,238.1225775586291,1.0,0,-147.89,2,1,0,-1.4799999999999995,2,1,0,-1.5773965250607596
Toms Tourney,2023-05-05,JinX @ Toms Tourney,Spain Women @ Toms Tourney,15,12,300.4922431832018,1.0,0,687.4000000000001,3,1,0,7.79,3,1,0,8.214557228083613
Toms Tourney,2023-05-05,LMU,Crazy Dogs @ Toms Tourney,15,3,600.0,1.0,1,631.13,12,1,0,11.91,12,1,0,12.63847233065881
Toms Tourney,2023-05-05,LMU,France Women @ Toms Tourney,12,10,238.1225775586291,1.0,0,-225.64000000000004,2,1,0,-2.7899999999999996,2,1,0,-3.530310949076867
Toms Tourney,2023-05-05,LMU,German masters @ Toms Tourney,15,2,600.0,1.0,0,490.62,13,1,0,8.120000000000001,13,1,0,8.73117178743966
Toms Tourney,2023-05-05,LMU,Germany U24 @ Toms Tourney,14,13,125.0,1.0,0,5.989999999999981,1,1,0,0.5100000000000002,1,1,0,-0.13424641552797745
Toms Tourney,2023-05-05,LMU,Panthers Wroclaw - Women @ Toms Tourney,12,10,238.1225775586291,1.0,0,37.67999999999998,2,1,0,1.42,2,1,0,1.3151147048913856
Toms Tourney,2023-05-05,LMU,Spain Women @ Toms Tourney,15,9,515.4814780292847,1.0,0,392.9,6,1,0,4.49,6,1,0,4.888712596081039
Toms Tourney,2023-05-05,NL Women @ Toms Tourney,Crazy Dogs @ Toms Tourney,15,4,600.0,1.0,0,712.99,11,1,0,12.16,11,1,0,12.77504239419029
Toms Tourney,2023-05-05,NL Women @ Toms Tourney,GB U24 Women,14,8,536.0348119187572,1.0,0,275.42,6,1,0,3.22,6,1,0,3.918058147240963
Toms Tourney,2023-05-05,NL Women @ Toms Tourney,Germany U24 @ Toms Tourney,15,13,214.17926913507503,1.0,0,87.85,2,1,0,0.7600000000000002,2,1,0,0.34943676704637916
Toms Tourney,2023-05-05,NL Women @ Toms Tourney,Panthers Wroclaw - Women @ Toms Tourney,12,11,125.0,1.0,0,119.53999999999999,1,1,0,1.67,1,1,0,1.7936273467888633
Toms Tourney,2023-05-05,NL Women @ Toms Tourney,Panthers Wroclaw - Women @ Toms Tourney,12,11,125.0,1.0,0,119.53999999999999,1,1,0,1.67,1,1,0,1.7936273467888633
Toms Tourney,2023-05-05,NL Women @ Toms Tourney,Spain Women @ Toms Tourney,13,9,418.5661446562001,1.0,0,474.76,4,1,0,4.74,4,1,0,5.316434699697297
Toms Tourney,2023-05-05,Panthers Wroclaw - Women @ Toms Tourney,GB U24 Women,12,6,579.3107485100336,0.9733285267845752,0,155.88,6,1,0,1.5500000000000003,6,1,0,2.192923463150237
Toms Tourney,2023-05-05,Panthers Wroclaw - Women @ Toms Tourney,German masters @ Toms Tourney,15,11,381.1647521399218,1.0,0,452.94,4,1,0,6.700000000000001,4,1,0,7.814875990246566
Toms Tourney,2023-05-05,Panthers Wroclaw - Women @ Toms Tourney,Spain Women @ Toms Tourney,14,9,473.8676990361691,1.0,0,355.22,5,1,0,3.0700000000000003,5,1,0,3.6787145908042085
Toms Tourney,2023-05-05,Shout @ Toms Tourney,Belgian Women @ Toms Tourney,13,10,328.14240231865136,1.0,0,168.75,3,1,0,1.2999999999999998,3,1,0,2.0105776176281083
Toms Tourney,2023-05-05,Shout @ Toms Tourney,Crazy Dogs @ Toms Tourney,15,4,600.0,1.0,0,988.8199999999999,11,1,0,15.93,11,1,0,13.80108951316031
Toms Tourney,2023-05-05,Shout @ Toms Tourney,Czech Women @ Toms Tourney,14,10,398.70186369942724,1.0,0,318.97999999999996,4,1,0,2.4800000000000004,4,1,0,3.013928522257263
Toms Tourney,2023-05-05,Shout @ Toms Tourney,Czech Women @ Toms Tourney,14,10,398.70186369942724,1.0,0,318.97999999999996,4,1,0,2.4800000000000004,4,1,0,3.013928522257263
Toms Tourney,2023-05-05,Shout @ Toms Tourney,DESKEAGH @ Toms Tourney,15,10,453.6039151898044,1.0,0,398.02,5,1,0,5.1,5,1,0,5.713987750051253
Toms Tourney,2023-05-05,Shout @ Toms Tourney,Germany U24 @ Toms Tourney,15,9,515.4814780292847,1.0,0,363.67999999999995,6,1,0,4.53,6,1,0,5.053613216949348
Toms Tourney,2023-05-05,Shout @ Toms Tourney,JinX @ Toms Tourney,14,10,398.70186369942724,1.0,0,63.18999999999994,4,1,0,0.7199999999999998,4,1,0,1.2391694443213979
Toms Tourney,2023-05-05,Spain Women @ Toms Tourney,German masters @ Toms Tourney,15,7,600.0,1.0,0,97.72,8,1,0,3.6300000000000003,8,1,0,4.742064419233625
Vienna Spring Break 2023,2023-05-20,3SB - Women @ Vienna Spring Break 2023,Chicas @ Vienna Spring Break 2023,14,8,536.0348119187572,1.0,0,330.15999999999997,6,1,0,5.96,6,1,0,6.738028782762729
Vienna Spring Break 2023,2023-05-20,AUT U24 Women @ Vienna Spring Break 2023,Mantis @ Vienna Spring Break 2023,11,10,125.0,1.0,0,92.08000000000004,1,1,0,1.0199999999999996,1,1,0,0.6895137315734488
Vienna Spring Break 2023,2023-05-20,Catchup Women @ Vienna Spring Break 2023,Zürich Ultimate Swarm @ Vienna Spring Break 2023,15,8,564.8086448756737,1.0,0,477.95,7,1,0,7.58,7,1,0,8.147641517400317
Vienna Spring Break 2023,2023-05-20,Chicas @ Vienna Spring Break 2023,Zürich Ultimate Swarm @ Vienna Spring Break 2023,15,10,453.6039151898044,1.0,0,332.99,5,1,0,3.41,5,1,0,4.029635316015344
Vienna Spring Break 2023,2023-05-20,East Block @ Vienna Spring Break 2023,3SB - Women @ Vienna Spring Break 2023,15,10,453.6039151898044,1.0,0,144.29999999999998,5,1,0,2.63,5,1,0,3.06642940267718
Vienna Spring Break 2023,2023-05-20,East Block @ Vienna Spring Break 2023,Catchup Women @ Vienna Spring Break 2023,15,9,515.4814780292847,1.0,0,329.5,6,1,0,4.42,6,1,0,5.14912116652193
Vienna Spring Break 2023,2023-05-20,East Block @ Vienna Spring Break 2023,Zürich Ultimate Swarm @ Vienna Spring Break 2023,15,4,600.0,1.0,0,807.45,11,1,0,12.0,11,1,0,11.207101761324658
Vienna Spring Break 2023,2023-05-20,SCRAM,Mantis @ Vienna Spring Break 2023,15,10,453.6039151898044,1.0,0,292.20000000000005,5,1,0,3.82,5,1,0,4.760282787079259
Vienna Spring Break 2023,2023-05-20,SYC,AUT U24 Women @ Vienna Spring Break 2023,15,7,600.0,1.0,0,470.52,8,1,0,6.03,8,1,0,6.951796014435775
Vienna Spring Break 2023,2023-05-20,Swiss Women Ultimate @ Vienna Spring Break 2023,AUT U24 Women @ Vienna Spring Break 2023,15,3,600.0,1.0,0,761.3299999999999,12,1,0,13.68,12,1,0,11.870063306429962
Vienna Spring Break 2023,2023-05-20,Swiss Women Ultimate @ Vienna Spring Break 2023,SCRAM,15,1,600.0,1.0,0,561.21,14,1,0,10.879999999999999,14,1,0,9.895650118372519
Vienna Spring Break 2023,2023-05-20,Swiss Women Ultimate @ Vienna Spring Break 2023,SYC,15,5,600.0,1.0,0,290.81,10,1,0,7.6499999999999995,10,1,0,7.7666803567963
Vienna Spring Break 2023,2023-05-20,box vienna @ Vienna Spring Break 2023,Mantis @ Vienna Spring Break 2023,15,6,600.0,1.0,0,794.3,9,1,0,10.17,9,1,0,9.935343930726336
Vienna Spring Break 2023,2023-05-20,box vienna @ Vienna Spring Break 2023,SCRAM,15,7,600.0,1.0,0,502.09999999999997,8,1,0,6.35,8,1,0,6.552370857869114
Vienna Spring Break 2023,2023-05-20,box vienna @ Vienna Spring Break 2023,SYC,15,13,214.17926913507503,1.0,0,231.7,2,1,0,3.1199999999999997,2,1,0,3.6639080892959193
Vienna Spring Break 2023,2023-05-20,troubles @ Vienna Spring Break 2023,3SB - Women @ Vienna Spring Break 2023,15,12,300.4922431832018,1.0,0,290.27,3,1,0,4.79,3,1,0,5.080190072754043
Vienna Spring Break 2023,2023-05-20,troubles @ Vienna Spring Break 2023,Catchup Women @ Vienna Spring Break 2023,15,14,125.0,1.0,0,475.47,1,1,0,6.58,1,1,0,6.967686590553946
Vienna Spring Break 2023,2023-05-20,troubles @ Vienna Spring Break 2023,Chicas @ Vienna Spring Break 2023,15,3,600.0,1.0,0,620.4300000000001,12,1,0,10.75,12,1,0,10.257664826054341
Vienna Spring Break 2023,2023-05-21,3SB - Women @ Vienna Spring Break 2023,SCRAM,15,8,564.8086448756737,1.0,0,451.18999999999994,7,1,0,6.449999999999999,7,1,0,6.272894830384185
Vienna Spring Break 2023,2023-05-21,Chicas @ Vienna Spring Break 2023,AUT U24 Women @ Vienna Spring Break 2023,10,7,389.6652919127421,0.9459053029269173,0,321.15,3,1,0,3.29,3,1,0,3.5961248886123407
Vienna Spring Break 2023,2023-05-21,East Block @ Vienna Spring Break 2023,Swiss Women Ultimate @ Vienna Spring Break 2023,14,12,220.95664314305532,1.0,0,34.27999999999997,2,1,0,-1.7999999999999998,2,1,0,-2.078295710373487
Vienna Spring Break 2023,2023-05-21,SYC,Catchup Women @ Vienna Spring Break 2023,10,8,262.66557693448596,0.9733285267845752,0,4.409999999999997,2,1,0,-1.43,2,1,0,-1.138555861020686
Vienna Spring Break 2023,2023-05-21,box vienna @ Vienna Spring Break 2023,East Block @ Vienna Spring Break 2023,15,11,381.1647521399218,1.0,0,-93.38999999999999,4,1,0,-2.73,4,1,0,-2.737244664464477
Vienna Spring Break 2023,2023-05-21,troubles @ Vienna Spring Break 2023,box vienna @ Vienna Spring Break 2023,15,4,600.0,1.0,0,239.36,11,1,0,4.890000000000001,11,1,0,4.775115848299468
Elite Invite,2023-05-29,Bristol,3SB - women @ Elite Invite,15,9,515.4814780292847,1.0,0,435.26,6,1,0,5.52,6,1,0,6.4933781908754575
Elite Invite,2023-05-29,Bristol,FABulous @ Elite Invite,15,4,600.0,1.0,0,239.24,11,1,0,4.2,11,1,0,4.655484954740164
Elite Invite,2023-05-29,Bristol,box vienna @ Elite Invite,13,12,125.0,1.0,0,37.03,1,1,0,0.6200000000000001,1,1,0,0.6947525537262607
Elite Invite,2023-05-29,FABulous @ Elite Invite,3SB - women @ Elite Invite,15,8,564.8086448756737,1.0,0,196.01999999999998,7,1,0,1.3199999999999998,7,1,0,2.1231483568347507
Elite Invite,2023-05-29,JinX @ Elite Invite,3SB - women @ Elite Invite,15,9,515.4814780292847,1.0,0,808.3199999999999,6,1,0,9.51,6,1,0,9.874860793974658
Elite Invite,2023-05-29,JinX @ Elite Invite,Bristol,15,6,600.0,1.0,0,373.06,9,1,0,3.9899999999999998,9,1,0,4.72923475769861
Elite Invite,2023-05-29,JinX @ Elite Invite,FABulous @ Elite Invite,15,6,600.0,1.0,0,612.3,9,1,0,8.19,9,1,0,8.548249514412483
Elite Invite,2023-05-29,JinX @ Elite Invite,Seagulls @ Elite Invite,12,8,441.15462425988915,1.0,0,185.45,4,1,0,1.96,4,1,0,2.2875151228024393
Elite Invite,2023-05-29,JinX @ Elite Invite,Yaka @ Elite Invite,12,11,125.0,1.0,0,-148.71999999999997,1,1,0,-2.3200000000000003,1,1,0,-2.6276169374640386
Elite Invite,2023-05-29,Seagulls @ Elite Invite,3SB - women @ Elite Invite,12,6,579.3107485100336,0.9733285267845752,0,622.87,6,1,0,7.55,6,1,0,8.434086472351773
Elite Invite,2023-05-29,Seagulls @ Elite Invite,Bristol,13,7,557.5316737222639,1.0,0,187.61,6,1,0,2.03,6,1,0,2.565049447067995
Elite Invite,2023-05-29,Seagulls @ Elite Invite,box vienna @ Elite Invite,15,9,515.4814780292847,1.0,0,224.64000000000001,6,1,0,2.65,6,1,0,3.234186173216873
Elite Invite,2023-05-29,Shout @ Elite Invite,3SB - women @ Elite Invite,15,9,515.4814780292847,1.0,0,831.01,6,1,0,10.190000000000001,6,1,0,10.34602413548895
Elite Invite,2023-05-29,Shout @ Elite Invite,FABulous @ Elite Invite,15,6,600.0,1.0,0,634.99,9,1,0,8.870000000000001,9,1,0,9.112505115898564
Elite Invite,2023-05-29,Shout @ Elite Invite,Seagulls @ Elite Invite,15,8,564.8086448756737,1.0,0,208.14,7,1,0,2.6400000000000006,7,1,0,3.1231571798476665
Elite Invite,2023-05-29,Shout @ Elite Invite,Seagulls @ Elite Invite,15,13,214.17926913507503,1.0,0,208.14,2,1,0,2.6400000000000006,2,1,0,3.1231571798476665
Elite Invite,2023-05-29,Shout @ Elite Invite,box vienna @ Elite Invite,15,9,515.4814780292847,1.0,0,432.78,6,1,0,5.290000000000001,6,1,0,6.084206509672121
Elite Invite,2023-05-29,Yaka @ Elite Invite,Bristol,15,10,453.6039151898044,1.0,0,521.78,5,1,0,6.3100000000000005,5,1,0,6.971803119140063
Elite Invite,2023-05-29,Yaka @ Elite Invite,FABulous @ Elite Invite,15,7,600.0,1.0,0,761.02,8,1,0,10.51,8,1,0,10.161458228874022
Elite Invite,2023-05-29,Yaka @ Elite Invite,JinX @ Elite Invite,15,5,600.0,1.0,0,148.71999999999997,10,1,0,2.3200000000000003,10,1,0,2.627616937464037
Elite Invite,2023-05-29,Yaka @ Elite Invite,Shout @ Elite Invite,14,12,220.95664314305532,1.0,0,126.02999999999997,2,1,0,1.6399999999999997,2,1,0,1.7825372092425233
Elite Invite,2023-05-29,Yaka @ Elite Invite,box vienna @ Elite Invite,15,9,515.4814780292847,1.0,0,558.81,6,1,0,6.93,6,1,0,7.504992267990826
Elite Invite,2023-05-29,box vienna @ Elite Invite,3SB - women @ Elite Invite,15,7,600.0,1.0,0,398.23,8,1,0,4.9,8,1,0,5.917267939713156
Elite Invite,2023-05-29,box vienna @ Elite Invite,FABulous @ Elite Invite,13,9,418.5661446562001,1.0,0,202.21,4,1,0,3.58,4,1,0,4.018498949606286
Windfarm,2023-06-03,Brighton Ultimate,Chameleons,10,3,600.0,0.8583950752789521,0,432.02999999999986,7,1,0,3.9299999999999997,7,1,0,5.719757270972423
Windfarm,2023-06-03,Brighton Ultimate,Flyght Women,7,5,328.14240231865136,0.7947194142390263,0,351.05000000000007,2,1,0,1.7799999999999994,2,1,0,3.295630305686224
Windfarm,2023-06-03,Brighton Ultimate,Guildford Ultimate Women,8,6,300.4922431832018,0.8583950752789521,0,498.1,2,1,0,4.01,2,1,0,5.124625630391407
Windfarm,2023-06-03,Brighton Ultimate,Yorkshire Women,12,2,600.0,0.9459053029269173,1,1043.9699999999998,10,1,0,10.81,10,1,0,10.619534015093805
Windfarm,2023-06-03,Bristol,Horizon,11,6,546.6949863040446,0.9459053029269173,0,510.72,5,1,0,5.9399999999999995,5,1,0,6.906369234211635
Windfarm,2023-06-03,Bristol,SYC,9,7,279.3368557106305,0.9176629354822471,0,154.0,2,1,0,2.15,2,1,0,2.618165051971392
Windfarm,2023-06-03,Chameleons,Guildford Ultimate Women,9,7,279.3368557106305,0.9176629354822471,0,66.07000000000016,2,1,0,0.08000000000000007,2,1,0,-0.6842747408467424
Windfarm,2023-06-03,Chameleons,Yorkshire Women,8,3,600.0,0.7608859102526822,1,611.94,5,1,0,6.880000000000001,5,1,0,6.711661586080712
Windfarm,2023-06-03,Flyght Women,Chameleons,10,6,496.1596377856195,0.9176629354822471,0,80.97999999999979,4,1,0,2.1500000000000004,4,1,0,2.6457875849775583
Windfarm,2023-06-03,Flyght Women,Guildford Ultimate Women,10,5,573.8977938505714,0.8885233166386386,0,147.04999999999995,5,1,0,2.2300000000000004,5,1,0,1.9774240382515345
Windfarm,2023-06-03,Flyght Women,Yorkshire Women,13,0,600.0,1.0,0,692.9199999999998,13,1,0,9.030000000000001,13,1,0,8.672955225715967
Windfarm,2023-06-03,GB U24 Women,Ireland U24 Women,11,5,600.0,0.9176629354822471,0,394.32,6,1,0,3.85,6,1,0,4.497002205177214
Windfarm,2023-06-03,GB U24 Women,Spice Ultimate,13,7,557.5316737222639,1.0,0,-11.57,6,1,0,-0.44000000000000006,6,1,0,-0.336693437122479
Windfarm,2023-06-03,GB Women,GB U20 Women,15,1,600.0,1.0,1,1264.94,14,1,0,16.490000000000002,14,1,0,13.586950227280788
Windfarm,2023-06-03,GB Women,Ice Age,14,8,536.0348119187572,1.0,0,375.6,6,1,0,2.4399999999999995,6,1,0,3.113110909107302
Windfarm,2023-06-03,GB Women,SYC,13,3,600.0,1.0,1,744.73,10,1,0,9.01,10,1,0,9.265244767498459
Windfarm,2023-06-03,GB Womens Masters,Horizon,11,8,365.60925011032475,1.0,0,653.1500000000001,3,1,0,8.46,3,1,0,8.972620367754242
Windfarm,2023-06-03,GB Womens Masters,SMOG Women,15,7,600.0,1.0,0,234.93,8,1,0,3.73,8,1,0,4.261687048240347
Windfarm,2023-06-03,GB Womens Masters,Spice Ultimate,15,6,600.0,1.0,0,176.08,9,1,0,2.9699999999999998,9,1,0,3.5685432040863176
Windfarm,2023-06-03,Guildford Ultimate Women,Yorkshire Women,10,4,600.0,0.8583950752789521,0,545.8699999999999,6,1,0,6.800000000000001,6,1,0,7.247992857911914
Windfarm,2023-06-03,Ice Age,GB U20 Women,15,0,600.0,1.0,0,889.34,15,1,0,14.05,15,1,0,12.89865331184749
Windfarm,2023-06-03,Ice Age,Lemmings 1,15,5,600.0,1.0,0,213.68,10,1,0,4.930000000000001,10,1,0,5.2836164350278345
Windfarm,2023-06-03,Ireland U24 Women,GB U20 Women,12,5,600.0,0.9459053029269173,0,234.67000000000002,7,1,0,4.890000000000001,7,1,0,7.8055826399052535
Windfarm,2023-06-03,Lemmings 1,Bristol,10,5,573.8977938505714,0.8885233166386386,0,1.4499999999999886,5,1,0,-0.51,5,1,0,-0.5053087231270226
Windfarm,2023-06-03,SMOG Women,GB U24 Women,12,9,345.3654772346762,1.0,0,-47.28,3,1,0,-0.32000000000000006,3,1,0,-0.4071499651157069
Windfarm,2023-06-03,SMOG Women,Horizon,12,7,520.5112660164395,1.0,0,418.22,5,1,0,4.7299999999999995,5,1,0,5.67547378312759
Windfarm,2023-06-03,SYC,Lemmings 1,11,9,249.2068104043629,1.0,0,-155.45,2,1,0,-1.6400000000000001,2,1,0,-2.1253532324159856
Windfarm,2023-06-03,Spice Ultimate,Ireland U24 Women,13,8,496.1596377856195,1.0,0,405.89,5,1,0,4.29,5,1,0,4.801385282778483
Windfarm,2023-06-04,Brighton Ultimate,Chameleons,13,7,557.5316737222639,1.0,0,432.02999999999986,6,1,0,3.9299999999999997,6,1,0,5.719757270972423
Windfarm,2023-06-04,Brighton Ultimate,Guildford Ultimate Women,9,6,418.5661446562001,0.8885233166386386,0,498.1,3,1,0,4.01,3,1,0,5.124625630391407
Windfarm,2023-06-04,Bristol,Spice Ultimate,11,9,249.2068104043629,1.0,0,33.650000000000006,2,1,0,0.44999999999999996,2,1,0,0.7508718731293538
Windfarm,2023-06-04,Chameleons,Flyght Women,9,6,418.5661446562001,0.8885233166386386,0,-80.97999999999979,3,1,0,-2.1500000000000004,3,1,0,-2.6457875849775583
Windfarm,2023-06-04,GB U20 Women,Brighton Ultimate,13,5,600.0,1.0,0,151.99,8,1,0,2.9000000000000004,8,1,0,3.2227420662092356
Windfarm,2023-06-04,GB U20 Women,Yorkshire Women,15,1,600.0,1.0,1,1195.96,14,1,0,13.71,14,1,0,12.014751296504976
Windfarm,2023-06-04,GB U24 Women,Ireland U24 Women,10,8,262.66557693448596,0.9733285267845752,0,394.32,2,1,0,3.85,2,1,0,4.497002205177214
Windfarm,2023-06-04,GB U24 Women,Lemmings 1,10,9,125.0,1.0,0,-46.669999999999995,1,1,0,-0.38,1,1,0,-0.5824569910011324
Windfarm,2023-06-04,GB U24 Women,SYC,11,9,249.2068104043629,1.0,0,108.78,2,1,0,1.26,2,1,0,1.5514320609793621
Windfarm,2023-06-04,GB Women,Ice Age,15,10,453.6039151898044,1.0,0,375.6,5,1,0,2.4399999999999995,5,1,0,3.113110909107302
Windfarm,2023-06-04,GB Women,SMOG Women,15,8,564.8086448756737,1.0,0,683.23,7,1,0,8.07,7,1,0,8.520352502912868
Windfarm,2023-06-04,Guildford Ultimate Women,Flyght Women,8,7,125.0,0.8885233166386386,0,-147.04999999999995,1,1,0,-2.2300000000000004,1,1,0,-1.9774240382515362
Windfarm,2023-06-04,Guildford Ultimate Women,Yorkshire Women,10,4,600.0,0.8583950752789521,0,545.8699999999999,6,1,0,6.800000000000001,6,1,0,7.247992857911914
Windfarm,2023-06-04,Horizon,Chameleons,15,1,600.0,1.0,1,747.5099999999999,14,1,0,10.52,14,1,0,11.901878064362908
Windfarm,2023-06-04,Horizon,GB U20 Women,10,8,262.66557693448596,0.9733285267845752,0,163.49,2,1,0,3.6900000000000004,2,1,0,6.461650972574503
Windfarm,2023-06-04,Ice Age,GB Womens Masters,15,13,214.17926913507503,1.0,0,72.69999999999999,2,1,0,1.9000000000000004,2,1,0,2.113592815262045
Windfarm,2023-06-04,Lemmings 1,Bristol,11,8,365.60925011032475,1.0,0,1.4499999999999886,3,1,0,-0.51,3,1,0,-0.5053087231270226
Windfarm,2023-06-04,Lemmings 1,Spice Ultimate,10,9,125.0,1.0,0,35.099999999999994,1,1,0,-0.06000000000000005,1,1,0,0.2459779476524755
Windfarm,2023-06-04,SMOG Women,GB Womens Masters,14,13,125.0,1.0,0,-234.93,1,1,0,-3.73,1,1,0,-4.261687048240347
Windfarm,2023-06-04,SYC,Bristol,11,8,365.60925011032475,1.0,0,-154.0,3,1,0,-2.15,3,1,0,-2.61816505197139
Windfarm,2023-06-04,SYC,Ireland U24 Women,11,8,365.60925011032475,1.0,0,285.54,3,1,0,2.5900000000000003,3,1,0,3.0398290749784493
Windfarm,2023-06-04,Spice Ultimate,Ireland U24 Women,12,7,520.5112660164395,1.0,0,405.89,5,1,0,4.29,5,1,0,4.801385282778483
Windmill,2023-06-16,3sb @ Windmill,Frizzly Bears Women @ Windmill,12,7,520.5112660164395,1.0,0,529.6100000000001,5,1,0,6.899999999999999,5,1,0,7.238791084199125
Windmill,2023-06-16,Austria Women @ Windmill,Iceni,13,8,496.1596377856195,1.0,0,123.52000000000004,5,1,0,1.94,5,1,0,1.6493047747770824
Windmill,2023-06-16,Austria Women @ Windmill,La SÃ©ptima @ Windmill,13,5,600.0,1.0,0,501.86,8,1,0,6.51,8,1,0,6.758367781150991
Windmill,2023-06-16,Austria Women @ Windmill,SYC,13,11,228.8403622143806,1.0,0,426.18,2,1,0,5.76,2,1,0,5.93752030658564
Windmill,2023-06-16,Belgium Women @ Windmill,Austria Women @ Windmill,13,11,228.8403622143806,1.0,0,-11.430000000000007,2,1,0,-0.33999999999999986,2,1,0,-0.17999136049763464
Windmill,2023-06-16,Belgium Women @ Windmill,Seagulls Hamburg @ Windmill,14,10,398.70186369942724,1.0,0,99.79000000000002,4,1,0,1.4300000000000002,4,1,0,1.6493047747770824
Windmill,2023-06-16,Belgium Women @ Windmill,Spice Ultimate,14,9,473.8676990361691,1.0,0,294.4,5,1,0,3.7199999999999998,5,1,0,4.099822719922997
Windmill,2023-06-16,Bristol,Frizzly Bears Women @ Windmill,15,5,600.0,1.0,1,901.94,10,1,0,11.93,10,1,0,10.958558754246244
Windmill,2023-06-16,Bristol,Spain Women @ Windmill,15,6,600.0,1.0,0,223.91000000000003,9,1,0,3.19,9,1,0,3.8802948187368926
Windmill,2023-06-16,Czech Republic Women @ Windmill,Belgium Women @ Windmill,15,11,381.1647521399218,1.0,0,127.37,4,1,0,1.6799999999999997,4,1,0,2.059166616102125
Windmill,2023-06-16,Czech Republic Women @ Windmill,France Women @ Windmill,12,10,238.1225775586291,1.0,0,-138.0,2,1,0,-1.7400000000000002,2,1,0,-1.95531070267511
Windmill,2023-06-16,Czech Republic Women @ Windmill,Spain Women @ Windmill,15,10,453.6039151898044,1.0,0,612.03,5,1,0,8.14,5,1,0,8.403775934285935
Windmill,2023-06-16,Electroclit @ Windmill,3sb @ Windmill,15,10,453.6039151898044,1.0,0,-68.10000000000002,5,1,0,-1.2200000000000002,5,1,0,-1.097535058672424
Windmill,2023-06-16,Electroclit @ Windmill,JinX @ Windmill,15,11,381.1647521399218,1.0,0,202.44,4,1,0,2.579999999999999,4,1,0,3.191966567135747
Windmill,2023-06-16,France Women @ Windmill,Bristol,13,7,557.5316737222639,1.0,0,526.12,6,1,0,6.6899999999999995,6,1,0,6.92703780035847
Windmill,2023-06-16,France Women @ Windmill,Poland Women @ Windmill,14,5,600.0,1.0,0,855.74,9,1,0,10.8,9,1,0,10.347203611297129
Windmill,2023-06-16,Germany Women @ Windmill,France Women @ Windmill,13,12,125.0,1.0,0,273.08000000000004,1,1,0,3.33,1,1,0,3.2012737702749483
Windmill,2023-06-16,Germany Women @ Windmill,Ireland Women @ Windmill,15,4,600.0,1.0,0,708.95,11,1,0,9.89,11,1,0,9.242946916799461
Windmill,2023-06-16,Germany Women @ Windmill,Mermaid lumberjacks @ Windmill,15,7,600.0,1.0,0,338.05000000000007,8,1,0,3.84,8,1,0,3.9822728428366467
Windmill,2023-06-16,Germany Women @ Windmill,Switzerland Women @ Windmill,15,7,600.0,1.0,0,564.6400000000001,8,1,0,7.3,8,1,0,7.1010774695909795
Windmill,2023-06-16,Iceni,Ireland Women @ Windmill,11,11,0.0,1.0,0,58.40999999999997,0,1,0,1.54,0,1,0,2.004685099942172
Windmill,2023-06-16,Ireland Women @ Windmill,Electroclit @ Windmill,15,9,515.4814780292847,1.0,0,530.6800000000001,6,1,0,6.380000000000001,6,1,0,6.6262135292158675
Windmill,2023-06-16,Ireland Women @ Windmill,JinX @ Windmill,15,6,600.0,1.0,0,733.12,9,1,0,8.959999999999999,9,1,0,8.97454669838859
Windmill,2023-06-16,JinX @ Windmill,Frizzly Bears Women @ Windmill,15,10,453.6039151898044,1.0,0,259.07000000000005,5,1,0,3.0999999999999996,5,1,0,3.4891925317010646
Windmill,2023-06-16,La SÃ©ptima @ Windmill,Electroclit @ Windmill,15,11,381.1647521399218,1.0,0,210.75,4,1,0,3.3500000000000005,4,1,0,3.4451769891003856
Windmill,2023-06-16,La SÃ©ptima @ Windmill,Poland Women @ Windmill,12,10,238.1225775586291,1.0,0,99.94,2,1,0,1.2099999999999997,2,1,0,1.5684954917024108
Windmill,2023-06-16,Mermaid lumberjacks @ Windmill,Czech Republic Women @ Windmill,14,10,398.70186369942724,1.0,0,73.02999999999997,4,1,0,1.2300000000000004,4,1,0,1.1355730999059013
Windmill,2023-06-16,Mermaid lumberjacks @ Windmill,Iceni,12,12,0.0,1.0,0,312.49,0,1,0,4.51,0,1,0,4.539283348509549
Windmill,2023-06-16,Mermaid lumberjacks @ Windmill,SYC,15,3,600.0,1.0,0,615.15,12,1,0,8.33,12,1,0,8.274228315481153
Windmill,2023-06-16,Poland Women @ Windmill,Frizzly Bears Women @ Windmill,15,5,600.0,1.0,0,572.32,10,1,0,7.819999999999999,10,1,0,7.8612192826376415
Windmill,2023-06-16,SYC,La SÃ©ptima @ Windmill,13,9,418.5661446562001,1.0,0,75.68,4,1,0,0.7500000000000001,4,1,0,0.9990189307748008
Windmill,2023-06-16,Seagulls Hamburg @ Windmill,3sb @ Windmill,14,12,220.95664314305532,1.0,0,533.29,2,1,0,6.87,2,1,0,7.206528925880374
Windmill,2023-06-16,Seagulls Hamburg @ Windmill,Iceni,13,12,125.0,1.0,0,12.300000000000011,1,1,0,0.16999999999999993,1,1,0,-0.17999136049763464
Windmill,2023-06-16,Seagulls Hamburg @ Windmill,SYC,12,9,345.3654772346762,1.0,0,314.96,3,1,0,3.9899999999999998,3,1,0,4.318844514144136
Windmill,2023-06-16,Spain Women @ Windmill,3sb @ Windmill,14,11,313.3379659704299,1.0,0,148.41999999999996,3,1,0,1.8400000000000003,3,1,0,2.070203469339088
Windmill,2023-06-16,Spice Ultimate,Poland Women @ Windmill,15,7,600.0,1.0,0,295.97,8,1,0,3.66,8,1,0,4.340844769118014
Windmill,2023-06-16,Spice Ultimate,Spain Women @ Windmill,15,8,564.8086448756737,1.0,0,190.26,7,1,0,2.74,7,1,0,3.1704785894176517
Windmill,2023-06-16,Switzerland Women @ Windmill,Bristol,13,8,496.1596377856195,1.0,0,234.56,5,1,0,2.72,5,1,0,2.988009227798468
Windmill,2023-06-16,Switzerland Women @ Windmill,JinX @ Windmill,15,5,600.0,1.0,0,877.4300000000001,10,1,0,11.55,10,1,0,10.707082625568233
Windmill,2023-06-16,Switzerland Women @ Windmill,Spice Ultimate,14,11,313.3379659704299,1.0,0,268.21000000000004,3,1,0,3.17,3,1,0,3.7019665370884596
Windmill,2023-06-17,3sb @ Windmill,JinX @ Windmill,15,10,453.6039151898044,1.0,0,270.54,5,1,0,3.7999999999999994,5,1,0,4.223737189019065
Windmill,2023-06-17,3sb @ Windmill,Poland Women @ Windmill,15,11,381.1647521399218,1.0,0,-42.70999999999998,4,1,0,-0.9200000000000004,4,1,0,-0.8331416632755051
Windmill,2023-06-17,Austria Women @ Windmill,Ireland Women @ Windmill,12,12,0.0,1.0,0,181.93,0,1,0,3.48,0,1,0,3.6010727239078477
Windmill,2023-06-17,Belgium Women @ Windmill,Austria Women @ Windmill,14,13,125.0,1.0,0,-11.430000000000007,1,1,0,-0.33999999999999986,1,1,0,-0.17999136049763464
Windmill,2023-06-17,Bristol,Seagulls Hamburg @ Windmill,9,9,0.0,0.9733285267845752,0,-160.95999999999998,0,1,0,-1.8399999999999999,0,1,0,-1.7906701707614587
Windmill,2023-06-17,Czech Republic Women @ Windmill,Switzerland Women @ Windmill,14,10,398.70186369942724,1.0,0,153.56,4,1,0,2.2299999999999995,4,1,0,2.4761334545176226
Windmill,2023-06-17,Electroclit @ Windmill,Frizzly Bears Women @ Windmill,14,10,398.70186369942724,1.0,0,461.51000000000005,4,1,0,5.679999999999999,4,1,0,6.36604318905778
Windmill,2023-06-17,France Women @ Windmill,Czech Republic Women @ Windmill,15,13,214.17926913507503,1.0,0,138.0,2,1,0,1.7400000000000002,2,1,0,1.9553107026751064
Windmill,2023-06-17,France Women @ Windmill,Mermaid lumberjacks @ Windmill,12,8,441.15462425988915,1.0,0,64.97000000000003,4,1,0,0.5099999999999998,4,1,0,0.8279077579929766
Windmill,2023-06-17,France Women @ Windmill,Spice Ultimate,15,9,515.4814780292847,1.0,0,559.77,6,1,0,7.14,6,1,0,7.504430003621806
Windmill,2023-06-17,Germany Women @ Windmill,Austria Women @ Windmill,14,8,536.0348119187572,1.0,0,527.02,6,1,0,6.41,6,1,0,6.621383521502061
Windmill,2023-06-17,Germany Women @ Windmill,Czech Republic Women @ Windmill,12,9,345.3654772346762,1.0,0,411.08000000000004,3,1,0,5.07,3,1,0,5.017011549126284
Windmill,2023-06-17,Germany Women @ Windmill,Mermaid lumberjacks @ Windmill,14,10,398.70186369942724,1.0,0,338.05000000000007,4,1,0,3.84,4,1,0,3.9822728428366467
Windmill,2023-06-17,Iceni,Bristol,15,9,515.4814780292847,1.0,0,148.65999999999997,6,1,0,1.67,6,1,0,1.967842660840759
Windmill,2023-06-17,Iceni,SYC,10,10,0.0,1.0,0,302.65999999999997,0,1,0,3.82,0,1,0,4.483346317614302
Windmill,2023-06-17,Ireland Women @ Windmill,Bristol,11,8,365.60925011032475,1.0,0,90.25,3,1,0,0.1299999999999999,3,1,0,-0.037499921875193465
Windmill,2023-06-17,La SÃ©ptima @ Windmill,3sb @ Windmill,14,11,313.3379659704299,1.0,0,142.64999999999998,3,1,0,2.13,3,1,0,2.387769214843619
Windmill,2023-06-17,La SÃ©ptima @ Windmill,Frizzly Bears Women @ Windmill,15,5,600.0,1.0,0,672.26,10,1,0,9.03,10,1,0,8.939802209862272
Windmill,2023-06-17,La SÃ©ptima @ Windmill,Spain Women @ Windmill,10,9,125.0,1.0,0,-5.769999999999996,1,1,0,0.2899999999999998,1,1,0,0.32469927030061285
Windmill,2023-06-17,Mermaid lumberjacks @ Windmill,Belgium Women @ Windmill,12,7,520.5112660164395,1.0,0,200.39999999999998,5,1,0,2.91,5,1,0,3.1618795773096195
Windmill,2023-06-17,Poland Women @ Windmill,JinX @ Windmill,15,8,564.8086448756737,1.0,0,313.25,7,1,0,4.72,7,1,0,4.979007802554609
Windmill,2023-06-17,SYC,Electroclit @ Windmill,11,8,365.60925011032475,1.0,0,286.43,3,1,0,4.1000000000000005,3,1,0,4.377237856485294
Windmill,2023-06-17,SYC,Poland Women @ Windmill,11,9,249.2068104043629,1.0,0,175.62,2,1,0,1.96,2,1,0,2.549757270431236
Windmill,2023-06-17,Seagulls Hamburg @ Windmill,Electroclit @ Windmill,15,4,600.0,1.0,0,601.39,11,1,0,8.09,11,1,0,8.02206459225792
Windmill,2023-06-17,Seagulls Hamburg @ Windmill,Ireland Women @ Windmill,15,6,600.0,1.0,0,70.70999999999998,9,1,0,1.71,9,1,0,1.827624648282825
Windmill,2023-06-17,Spain Women @ Windmill,Frizzly Bears Women @ Windmill,15,6,600.0,1.0,0,678.0300000000001,9,1,0,8.739999999999998,9,1,0,8.727699858672853
Windmill,2023-06-17,Spain Women @ Windmill,JinX @ Windmill,15,10,453.6039151898044,1.0,0,418.96,5,1,0,5.64,5,1,0,6.058494233464778
Windmill,2023-06-17,Spice Ultimate,Iceni,13,8,496.1596377856195,1.0,0,-182.30999999999997,5,1,0,-2.12,5,1,0,-2.7009769458111528
Windmill,2023-06-17,Switzerland Women @ Windmill,Belgium Women @ Windmill,10,10,0.0,1.0,0,-26.189999999999998,0,1,0,-0.5499999999999998,0,1,0,-0.42663489975920044
Windmill,2023-06-17,Switzerland Women @ Windmill,Spice Ultimate,12,10,238.1225775586291,1.0,0,268.21000000000004,2,1,0,3.17,2,1,0,3.7019665370884596
Windmill,2023-06-18,Austria Women @ Windmill,Spice Ultimate,15,5,600.0,1.0,0,305.83000000000004,10,1,0,4.06,10,1,0,4.265823456024805
Windmill,2023-06-18,Bristol,JinX @ Windmill,15,7,600.0,1.0,0,642.87,8,1,0,8.83,8,1,0,8.998586941849915
Windmill,2023-06-18,Germany Women @ Windmill,France Women @ Windmill,13,11,228.8403622143806,1.0,0,273.08000000000004,2,1,0,3.33,2,1,0,3.2012737702749483
Windmill,2023-06-18,Ireland Women @ Windmill,3sb @ Windmill,15,9,515.4814780292847,1.0,0,462.58,6,1,0,5.16,6,1,0,5.7133465700261645
Windmill,2023-06-18,Mermaid lumberjacks @ Windmill,Czech Republic Women @ Windmill,15,10,453.6039151898044,1.0,0,73.02999999999997,5,1,0,1.2300000000000004,5,1,0,1.1355730999059013
Windmill,2023-06-18,Poland Women @ Windmill,Electroclit @ Windmill,15,9,515.4814780292847,1.0,0,110.81,6,1,0,2.1400000000000006,6,1,0,1.9228621913353194
Windmill,2023-06-18,SYC,Frizzly Bears Women @ Windmill,15,5,600.0,1.0,1,747.94,10,1,0,9.78,10,1,0,9.559376286753558
Windmill,2023-06-18,Seagulls Hamburg @ Windmill,La SÃ©ptima @ Windmill,10,6,496.1596377856195,0.9176629354822471,0,390.64,4,1,0,4.74,4,1,0,5.217806613033908
Windmill,2023-06-18,Spain Women @ Windmill,Iceni,13,11,228.8403622143806,1.0,0,-372.57,2,1,0,-4.859999999999999,2,1,0,-5.656183949967023
Windmill,2023-06-18,Switzerland Women @ Windmill,Belgium Women @ Windmill,13,11,228.8403622143806,1.0,0,-26.189999999999998,2,1,0,-0.5499999999999998,2,1,0,-0.42663489975920044
London Invite,2023-06-23,AUSU24s @ London Invite,GB Women,13,12,125.0,1.0,0,-78.51999999999998,1,1,0,-1.0599999999999996,1,1,0,-1.0855986069538446
London Invite,2023-06-23,AUSU24s @ London Invite,GBWU24 @ London Invite,11,8,365.60925011032475,1.0,0,343.08000000000004,3,1,0,3.2200000000000006,3,1,0,3.234186173216873
London Invite,2023-06-23,AUSU24s @ London Invite,GBWU24 @ London Invite,7,3,600.0,0.7254762501100116,0,343.08000000000004,4,1,0,3.2200000000000006,4,1,0,3.234186173216873
London Invite,2023-06-23,GB Masters Women @ London Invite,AUSU24s @ London Invite,13,11,228.8403622143806,1.0,0,-112.05000000000007,2,1,0,-0.5,2,1,0,-0.493322020613272
London Invite,2023-06-23,GB Masters Women @ London Invite,GBWU24 @ London Invite,15,7,600.0,1.0,0,231.02999999999997,8,1,0,2.7200000000000006,8,1,0,2.7604386717628344
London Invite,2023-06-23,GB Women,GB Masters Women @ London Invite,12,10,238.1225775586291,1.0,0,190.57000000000005,2,1,0,1.5599999999999996,2,1,0,1.5751713717759301
London Invite,2023-06-23,GB Women,Yaka @ London Invite,15,10,453.6039151898044,1.0,0,-99.17999999999995,5,1,0,-0.8200000000000003,5,1,0,-0.8301508850925678
London Invite,2023-06-23,GBWU24 @ London Invite,GB Masters Women @ London Invite,7,4,496.1596377856195,0.7608859102526822,0,-231.02999999999997,3,1,0,-2.7200000000000006,3,1,0,-2.760438671762836
London Invite,2023-06-23,Yaka @ London Invite,AUSU24s @ London Invite,11,9,249.2068104043629,1.0,0,177.69999999999993,2,1,0,1.88,2,1,0,1.9081067980150443
London Invite,2023-06-23,Yaka @ London Invite,GB Masters Women @ London Invite,14,10,398.70186369942724,1.0,0,289.75,4,1,0,2.38,4,1,0,2.3914240452888933
London Invite,2023-06-23,Yaka @ London Invite,GB Women,13,8,496.1596377856195,1.0,0,99.17999999999995,5,1,0,0.8200000000000003,5,1,0,0.8301508850925696
London Invite,2023-06-23,Yaka @ London Invite,GBWU24 @ London Invite,13,8,496.1596377856195,1.0,0,520.78,5,1,0,5.1000000000000005,5,1,0,5.005018166401161
EUCR Gent,2023-08-07,FABulous @ EUCR Gent,Wuf. @ EUCR Gent,15,12,300.4922431832018,1.0,0,370.02,3,1,0,4.29,3,1,0,4.460796260472158
EUCR Gent,2023-08-07,Heidees Frauen @ EUCR Gent,FABulous @ EUCR Gent,15,11,381.1647521399218,1.0,0,300.83000000000004,4,1,0,3.42,4,1,0,3.4679025656418077
EUCR Gent,2023-08-07,Heidees Frauen @ EUCR Gent,FABulous @ EUCR Gent,13,11,228.8403622143806,1.0,0,300.83000000000004,2,1,0,3.42,2,1,0,3.4679025656418077
EUCR Gent,2023-08-07,Heidees Frauen @ EUCR Gent,Lillipuc @ EUCR Gent,11,5,600.0,0.9176629354822471,0,659.63,6,1,0,6.9399999999999995,6,1,0,6.848913715765104
EUCR Gent,2023-08-07,Heidees Frauen @ EUCR Gent,Seagulls @ EUCR Gent,15,9,515.4814780292847,1.0,0,398.48,6,1,0,3.87,6,1,0,4.077605934769771
EUCR Gent,2023-08-07,Jetset LUV @ EUCR Gent,Lillipuc @ EUCR Gent,15,11,381.1647521399218,1.0,0,439.23,4,1,0,4.529999999999999,4,1,0,4.709637826446944
EUCR Gent,2023-08-07,Jetset LUV @ EUCR Gent,Seagulls @ EUCR Gent,14,11,313.3379659704299,1.0,0,178.08,3,1,0,1.46,3,1,0,1.6552319749409712
EUCR Gent,2023-08-07,Jetset LUV @ EUCR Gent,Seagulls @ EUCR Gent,13,8,496.1596377856195,1.0,0,178.08,5,1,0,1.46,5,1,0,1.6552319749409712
EUCR Gent,2023-08-07,Jetset LUV @ EUCR Gent,Wuf. @ EUCR Gent,14,12,220.95664314305532,1.0,0,450.45,2,1,0,5.3,2,1,0,5.362936734652379
EUCR Gent,2023-08-07,Lillipuc @ EUCR Gent,Wuf. @ EUCR Gent,9,8,125.0,0.9459053029269173,0,11.21999999999997,1,1,0,0.7700000000000005,1,1,0,0.7359087163274918
EUCR Gent,2023-08-07,Mooncup @ EUCR Gent,FABulous @ EUCR Gent,14,7,582.8868714046324,1.0,0,618.3299999999999,7,1,0,6.7,7,1,0,6.557831777125685
EUCR Gent,2023-08-07,Mooncup @ EUCR Gent,Heidees Frauen @ EUCR Gent,15,13,214.17926913507503,1.0,0,317.5,2,1,0,3.2800000000000002,2,1,0,3.4373612082055267
EUCR Gent,2023-08-07,Mooncup @ EUCR Gent,Seagulls @ EUCR Gent,13,7,557.5316737222639,1.0,0,715.98,6,1,0,7.15,6,1,0,7.074280218664178
EUCR Gent,2023-08-07,Mooncup @ EUCR Gent,Tequila Boom Boom @ EUCR Gent,12,8,441.15462425988915,1.0,0,262.54999999999995,4,1,0,2.93,4,1,0,3.0405482658211085
EUCR Gent,2023-08-07,Mooncup @ EUCR Gent,Tequila Boom Boom @ EUCR Gent,15,11,381.1647521399218,1.0,0,262.54999999999995,4,1,0,2.93,4,1,0,3.0405482658211085
EUCR Gent,2023-08-07,Seagulls @ EUCR Gent,Lillipuc @ EUCR Gent,12,9,345.3654772346762,1.0,0,261.15,3,1,0,3.0699999999999994,3,1,0,3.164029534489824
EUCR Gent,2023-08-07,Seagulls @ EUCR Gent,Wuf. @ EUCR Gent,15,5,600.0,1.0,0,272.37,10,1,0,3.84,10,1,0,3.8599926975662164
EUCR Gent,2023-08-07,Tequila Boom Boom @ EUCR Gent,FABulous @ EUCR Gent,14,11,313.3379659704299,1.0,0,355.78000000000003,3,1,0,3.77,3,1,0,3.859292353701143
EUCR Gent,2023-08-07,Tequila Boom Boom @ EUCR Gent,Heidees Frauen @ EUCR Gent,13,11,228.8403622143806,1.0,0,54.95000000000002,2,1,0,0.3500000000000001,2,1,0,0.41614318672916184
EUCR Gent,2023-08-07,Tequila Boom Boom @ EUCR Gent,Jetset LUV @ EUCR Gent,12,8,441.15462425988915,1.0,0,275.35,4,1,0,2.76,4,1,0,2.9000342194426203
EUCR Gent,2023-08-07,Wuf. @ EUCR Gent,Lillipuc @ EUCR Gent,11,10,125.0,1.0,0,-11.21999999999997,1,1,0,-0.7700000000000005,1,1,0,-0.7359087163274936
August Edition,2023-08-12,Brighton Ultimate,Mint,10,4,600.0,0.8583950752789521,0,542.11,6,1,0,2.879999999999999,6,1,0,5.081517972235236
August Edition,2023-08-12,Bristol,Brighton Ultimate,15,0,600.0,1.0,1,826.2,15,1,0,12.530000000000001,15,1,0,12.397311645222015
August Edition,2023-08-12,Bristol,Brixton,15,3,600.0,1.0,1,738.5,12,1,0,11.0,12,1,0,11.75845375625627
August Edition,2023-08-12,Iceni,Bristol,13,9,418.5661446562001,1.0,0,148.65999999999997,4,1,0,1.67,4,1,0,1.967842660840759
August Edition,2023-08-12,Iceni,Brixton,15,1,600.0,1.0,1,887.16,14,1,0,12.67,14,1,0,12.44632784778771
August Edition,2023-08-12,Iceni,Mint,15,0,600.0,1.0,1,1516.97,15,1,0,17.08,15,1,0,13.956485640882931
August Edition,2023-08-12,SYC,Brixton,15,2,600.0,1.0,0,584.5,13,1,0,8.85,13,1,0,10.589146166674286
August Edition,2023-08-12,SYC,Iceni,9,5,529.0591339672189,0.8583950752789521,0,-302.65999999999997,4,1,0,-3.82,4,1,0,-4.4833463176143
August Edition,2023-08-12,Spice Ultimate,Brighton Ultimate,15,1,600.0,1.0,1,792.5500000000001,14,1,0,12.08,14,1,0,12.149076360194506
August Edition,2023-08-12,Spice Ultimate,Mint,15,1,600.0,1.0,1,1334.66,14,1,0,14.959999999999999,14,1,0,13.52075465493634
August Edition,2023-08-12,Spice Ultimate,SYC,9,8,125.0,0.9459053029269173,0,120.35,1,1,0,1.7000000000000002,1,1,0,1.8837522041593537
August Edition,2023-08-13,Bristol,Mint,15,1,600.0,1.0,1,1368.31,14,1,0,15.41,14,1,0,13.655470205113694
August Edition,2023-08-13,Bristol,SYC,11,7,466.89332573293274,0.9733285267845752,0,154.0,4,1,0,2.15,4,1,0,2.618165051971392
August Edition,2023-08-13,Brixton,Brighton Ultimate,9,8,125.0,0.9459053029269173,0,87.70000000000005,1,1,0,1.5300000000000011,1,1,0,1.8143236060266439
August Edition,2023-08-13,Brixton,Mint,10,5,573.8977938505714,0.8885233166386386,0,629.8100000000001,5,1,0,4.41,5,1,0,6.624402476282565
August Edition,2023-08-13,Iceni,Brighton Ultimate,15,0,600.0,1.0,1,974.86,15,1,0,14.200000000000001,15,1,0,12.959952259273951
August Edition,2023-08-13,Iceni,Spice Ultimate,12,9,345.3654772346762,1.0,0,182.30999999999997,3,1,0,2.12,3,1,0,2.7009769458111528
August Edition,2023-08-13,SYC,Brighton Ultimate,15,1,600.0,1.0,1,672.2,14,1,0,10.38,14,1,0,11.427690381556712
August Edition,2023-08-13,SYC,Mint,15,1,600.0,1.0,1,1214.31,14,1,0,13.26,14,1,0,13.122449200434168
August Edition,2023-08-13,Spice Ultimate,Bristol,10,6,496.1596377856195,0.9176629354822471,0,-33.650000000000006,4,1,0,-0.44999999999999996,4,1,0,-0.7508718731293538
August Edition,2023-08-13,Spice Ultimate,Brixton,15,3,600.0,1.0,1,704.85,12,1,0,10.549999999999999,12,1,0,11.457165762385394
EUCR Warsaw,2023-08-27,3SB - women @ EUCR Warsaw,Panthers Wroclaw @ EUCR Warsaw,15,11,381.1647521399218,1.0,0,-31.669999999999987,4,1,0,-0.8599999999999999,4,1,0,-0.8009873643053496
EUCR Warsaw,2023-08-27,East Block @ EUCR Warsaw,3SB - women @ EUCR Warsaw,15,5,600.0,1.0,0,599.12,10,1,0,7.46,10,1,0,7.162026572685956
EUCR Warsaw,2023-08-27,East Block @ EUCR Warsaw,Panthers Wroclaw @ EUCR Warsaw,15,11,381.1647521399218,1.0,0,567.45,4,1,0,6.6,4,1,0,6.527466177908259
EUCR Warsaw,2023-08-27,East Block @ EUCR Warsaw,Troubles Warsaw @ EUCR Warsaw,15,12,300.4922431832018,1.0,0,143.98000000000002,3,1,0,1.86,3,1,0,1.9228621913353194
EUCR Warsaw,2023-08-27,East Block @ EUCR Warsaw,Troubles Warsaw @ EUCR Warsaw,15,13,214.17926913507503,1.0,0,143.98000000000002,2,1,0,1.86,2,1,0,1.9228621913353194
EUCR Warsaw,2023-08-27,East Block @ EUCR Warsaw,box vienna @ EUCR Warsaw,12,10,238.1225775586291,1.0,0,279.42,2,1,0,3.23,2,1,0,3.342706543302434
EUCR Warsaw,2023-08-27,Panthers Wroclaw @ EUCR Warsaw,3SB - women @ EUCR Warsaw,14,8,536.0348119187572,1.0,0,31.669999999999987,6,1,0,0.8599999999999999,6,1,0,0.8009873643053496
EUCR Warsaw,2023-08-27,Troubles Warsaw @ EUCR Warsaw,3SB - women @ EUCR Warsaw,15,10,453.6039151898044,1.0,0,455.14,5,1,0,5.6,5,1,0,5.580745442421939
EUCR Warsaw,2023-08-27,Troubles Warsaw @ EUCR Warsaw,Panthers Wroclaw @ EUCR Warsaw,14,9,473.8676990361691,1.0,0,423.47,5,1,0,4.74,5,1,0,4.876643029712181
EUCR Warsaw,2023-08-27,Troubles Warsaw @ EUCR Warsaw,box vienna @ EUCR Warsaw,14,11,313.3379659704299,1.0,0,135.44,3,1,0,1.37,3,1,0,1.4615977434353198
EUCR Warsaw,2023-08-27,box vienna @ EUCR Warsaw,3SB - women @ EUCR Warsaw,13,11,228.8403622143806,1.0,0,319.7,2,1,0,4.2299999999999995,2,1,0,4.274094153788539
EUCR Warsaw,2023-08-27,box vienna @ EUCR Warsaw,Panthers Wroclaw @ EUCR Warsaw,15,9,515.4814780292847,1.0,0,288.03,6,1,0,3.37,6,1,0,3.526768458972427
Nationals,2023-08-27,Bristol,Chameleons,13,2,600.0,1.0,1,1258.23,11,1,0,16.46,11,1,0,13.775627155150726
Nationals,2023-08-27,Bristol,Flame,9,8,125.0,0.9459053029269173,0,200.05,1,1,0,2.8600000000000003,1,1,0,2.5089515243163802
Nationals,2023-08-27,Bristol,LMU,10,7,389.6652919127421,0.9459053029269173,0,-148.33999999999997,3,1,0,-2.08,3,1,0,-2.4177301987023903
Nationals,2023-08-27,Dublin Gravity,Horizon,13,5,600.0,1.0,0,390.69,8,1,0,4.68,8,1,0,5.737694225548864
Nationals,2023-08-27,Dublin Gravity,SCRAM,9,7,279.3368557106305,0.9176629354822471,0,304.36999999999995,2,1,0,4.12,2,1,0,4.376551713845341
Nationals,2023-08-27,Flame,Chameleons,13,3,600.0,1.0,0,1058.1799999999998,10,1,0,13.6,10,1,0,13.311456144602076
Nationals,2023-08-27,Iceni,Bristol,11,8,365.60925011032475,1.0,0,148.65999999999997,3,1,0,1.67,3,1,0,1.967842660840759
Nationals,2023-08-27,Iceni,Chameleons,13,1,600.0,1.0,1,1406.8899999999999,12,1,0,18.13,12,1,0,14.050632903156792
Nationals,2023-08-27,Iceni,Flame,10,4,600.0,0.8583950752789521,0,348.71,6,1,0,4.53,6,1,0,4.380668269297409
Nationals,2023-08-27,Iceni,LMU,9,4,600.0,0.8271701918685112,0,0.3199999999999932,5,1,0,-0.41000000000000014,5,1,0,-0.4596060875794592
Nationals,2023-08-27,LMU,Chameleons,13,0,600.0,1.0,1,1406.57,13,1,0,18.54,13,1,0,14.10539799339821
Nationals,2023-08-27,LMU,Flame,13,3,600.0,1.0,0,348.39,10,1,0,4.94,10,1,0,4.797345961025535
Nationals,2023-08-27,SCRAM,Horizon,13,5,600.0,1.0,0,86.32000000000005,8,1,0,0.56,8,1,0,1.5321380792202604
Nationals,2023-08-27,SYC,Dublin Gravity,10,6,496.1596377856195,0.9176629354822471,0,-33.97,4,1,0,-0.8899999999999999,4,1,0,-1.2198004553184685
Nationals,2023-08-27,SYC,Horizon,9,6,418.5661446562001,0.8885233166386386,0,356.72,3,1,0,3.79,3,1,0,4.662938985104578
Nationals,2023-08-27,SYC,SCRAM,9,7,279.3368557106305,0.9176629354822471,0,270.4,2,1,0,3.23,2,1,0,3.2334710320418125
Nationals,2023-08-27,Spice Ultimate,Dublin Gravity,9,4,600.0,0.8271701918685112,0,86.38,5,1,0,0.81,5,1,0,0.6708022852679001
Nationals,2023-08-27,Spice Ultimate,Horizon,11,4,600.0,0.9176629354822471,0,477.07000000000005,7,1,0,5.49,7,1,0,6.300716223901308
Nationals,2023-08-27,Spice Ultimate,SCRAM,11,6,546.6949863040446,0.9459053029269173,0,390.75,5,1,0,4.93,5,1,0,4.982344350295179
Nationals,2023-08-27,Spice Ultimate,SYC,9,3,600.0,0.8271701918685112,0,120.35,6,1,0,1.7000000000000002,6,1,0,1.8837522041593537
Nationals,2023-08-28,Bristol,Dublin Gravity,11,7,466.89332573293274,0.9733285267845752,0,120.03,4,1,0,1.26,4,1,0,1.418498697325294
Nationals,2023-08-28,Bristol,Spice Ultimate,10,9,125.0,1.0,0,33.650000000000006,1,1,0,0.44999999999999996,1,1,0,0.7508718731293538
Nationals,2023-08-28,Flame,Dublin Gravity,12,9,345.3654772346762,1.0,0,-80.02000000000001,3,1,0,-1.6,3,1,0,-1.1079783081982768
Nationals,2023-08-28,Flame,Horizon,13,10,328.14240231865136,1.0,0,310.67,3,1,0,3.08,3,1,0,4.764329195872605
Nationals,2023-08-28,Flame,SYC,11,8,365.60925011032475,1.0,0,-46.050000000000004,3,1,0,-0.7100000000000001,3,1,0,0.11249789067245963
Nationals,2023-08-28,Horizon,Chameleons,14,6,600.0,1.0,1,747.5099999999999,8,1,0,10.52,8,1,0,11.901878064362908
Nationals,2023-08-28,Iceni,Bristol,13,10,328.14240231865136,1.0,0,148.65999999999997,3,1,0,1.67,3,1,0,1.967842660840759
Nationals,2023-08-28,Iceni,LMU,11,8,365.60925011032475,1.0,0,0.3199999999999932,3,1,0,-0.41000000000000014,3,1,0,-0.4596060875794592
Nationals,2023-08-28,LMU,SYC,10,8,262.66557693448596,0.9733285267845752,0,302.34,2,1,0,4.23,2,1,0,4.898095143508733
Nationals,2023-08-28,LMU,Spice Ultimate,15,6,600.0,1.0,0,181.98999999999998,9,1,0,2.5300000000000002,9,1,0,3.1432409287486536
Nationals,2023-08-28,SCRAM,Chameleons,15,7,600.0,1.0,0,833.8299999999999,8,1,0,11.08,8,1,0,12.426869686901398
Nationals,2023-08-28,SCRAM,Dublin Gravity,15,9,515.4814780292847,1.0,0,-304.36999999999995,6,1,0,-4.12,6,1,0,-4.376551713845341
Nationals,2023-08-28,SYC,SCRAM,15,8,564.8086448756737,1.0,0,270.4,7,1,0,3.23,7,1,0,3.2334710320418125
