Tournament,Date,Team_1,Team_2,Score_1,Score_2,Game_Rank_Diff_USAU,Game_Wght_USAU,Is_Ignored_USAU,Team_Rank_Diff_USAU,Game_Rank_Diff_Windmill,Game_Wght_Windmill,Is_Ignored_Windmill,Team_Rank_Diff_Windmill,Game_Rank_Diff_Sigmoid,Game_Wght_Sigmoid,Is_Ignored_Sigmoid,Team_Rank_Diff_Sigmoid
Reading Half 2022,2022-04-02,BN1,Cambridge Ultimate 2,13,2,600.0,1.0,0,524.09,11,1,0,7.96,11,1,0,7.453711101943455
Reading Half 2022,2022-04-02,BN1,Guildford Ultimate,11,4,600.0,0.9176629354822471,0,209.5,7,1,0,3.81,7,1,0,3.6653185600224063
Reading Half 2022,2022-04-02,BN1,Zoo,11,3,600.0,0.9176629354822471,0,412.22,8,1,0,6.27,8,1,0,6.154226838583643
Reading Half 2022,2022-04-02,Big Fish Little Fish,Brixton,11,5,600.0,0.9176629354822471,0,812.18,6,1,0,8.870000000000001,6,1,0,8.844462857725546
Reading Half 2022,2022-04-02,Big Fish Little Fish,Purple Cobras,11,5,600.0,0.9176629354822471,0,547.3399999999999,6,1,0,5.49,6,1,0,5.897624063696522
Reading Half 2022,2022-04-02,Big Fish Little Fish,Reading 3,11,5,600.0,0.9176629354822471,0,575.25,6,1,0,6.1899999999999995,6,1,0,6.4378088563959395
Reading Half 2022,2022-04-02,Big Fish Little Fish,Thundering Herd,12,5,600.0,0.9459053029269173,0,469.28,7,1,0,4.4399999999999995,7,1,0,4.649384309312982
Reading Half 2022,2022-04-02,Brixton,Sharkbear!,12,1,600.0,0.9459053029269173,0,496.37,11,1,0,7.76,11,1,0,7.560517079159709
Reading Half 2022,2022-04-02,Brixton,Zoo,8,7,125.0,0.8885233166386386,0,-51.099999999999994,1,1,0,-1.06,1,1,0,-1.3314862874271434
Reading Half 2022,2022-04-02,Cambridge,Oxford Ultimate,13,6,600.0,1.0,0,-321.24,7,1,0,-4.06,7,1,0,-4.476515310464649
Reading Half 2022,2022-04-02,Cambridge Ultimate 2,St Albans,9,5,529.0591339672189,0.8583950752789521,0,141.14999999999998,4,1,0,1.4400000000000004,4,1,0,1.8896572799493185
Reading Half 2022,2022-04-02,Deep,Space,10,9,125.0,1.0,0,-96.77,1,1,0,-1.1800000000000002,1,1,0,-0.8151960057899146
Reading Half 2022,2022-04-02,Deep,Thundering Herd Masters,9,5,529.0591339672189,0.8583950752789521,0,375.21,4,1,0,4.4,4,1,0,4.562436171277696
Reading Half 2022,2022-04-02,Guildford Ultimate,St Albans,11,6,546.6949863040446,0.9459053029269173,0,455.74,5,1,0,5.590000000000001,5,1,0,5.9848862386643695
Reading Half 2022,2022-04-02,Guildford Ultimate,Thundering Herd,8,3,600.0,0.7608859102526822,0,-89.08000000000001,5,1,0,-0.91,5,1,0,-1.2130948477805283
Reading Half 2022,2022-04-02,Lemmings,Deep,8,6,300.4922431832018,0.8583950752789521,0,318.39,2,1,0,3.06,2,1,0,3.576325253358416
Reading Half 2022,2022-04-02,Lemmings,Reading 2,11,6,546.6949863040446,0.9459053029269173,0,161.96999999999997,5,1,0,0.8799999999999999,5,1,0,1.4719973398971717
Reading Half 2022,2022-04-02,Lemmings,Thundering Herd Masters,11,6,546.6949863040446,0.9459053029269173,0,693.5999999999999,5,1,0,7.46,5,1,0,7.58845491379255
Reading Half 2022,2022-04-02,Mixed Feelings,Brixton,9,8,125.0,0.9459053029269173,0,247.91,1,1,0,3.54,1,1,0,3.8382736714883308
Reading Half 2022,2022-04-02,Mixed Feelings,Cambridge Ultimate 2,9,5,529.0591339672189,0.8583950752789521,0,308.68,4,1,0,4.17,4,1,0,4.120633317705408
Reading Half 2022,2022-04-02,Mixed Feelings,St Albans,7,5,328.14240231865136,0.7947194142390263,0,449.83,2,1,0,5.61,2,1,0,5.809249643587471
Reading Half 2022,2022-04-02,Oxford Ultimate,Space,10,7,389.6652919127421,0.9459053029269173,0,58.099999999999994,3,1,0,-0.050000000000000266,3,1,0,0.22573295723096543
Reading Half 2022,2022-04-02,Oxford Ultimate,Thundering Herd Masters,11,7,466.89332573293274,0.9733285267845752,0,530.0799999999999,4,1,0,5.529999999999999,4,1,0,5.486796956741685
Reading Half 2022,2022-04-02,Purple Cobras,BN1,8,4,564.8086448756737,0.7947194142390263,0,-198.48000000000002,4,1,0,-3.9499999999999997,4,1,0,-3.8620936210187153
Reading Half 2022,2022-04-02,Purple Cobras,Guildford Ultimate,7,5,328.14240231865136,0.7947194142390263,0,11.020000000000003,2,1,0,-0.13999999999999999,2,1,0,-0.2099862810755635
Reading Half 2022,2022-04-02,Purple Cobras,Mixed Feelings,10,6,496.1596377856195,0.9176629354822471,0,16.930000000000003,4,1,0,-0.16,4,1,0,-0.0022499999831246953
Reading Half 2022,2022-04-02,Reading,Cambridge,13,8,496.1596377856195,1.0,0,789.86,5,1,0,10.43,5,1,0,10.211165864671774
Reading Half 2022,2022-04-02,Reading,Lemmings,11,6,546.6949863040446,0.9459053029269173,0,305.1,5,1,0,4.44,5,1,0,5.0329914953392105
Reading Half 2022,2022-04-02,Reading,Oxford Ultimate,13,7,557.5316737222639,1.0,0,468.62,6,1,0,6.370000000000001,6,1,0,7.196717851714162
Reading Half 2022,2022-04-02,Reading,Space,9,8,125.0,0.9459053029269173,0,526.72,1,1,0,6.32,1,1,0,7.3692436773159855
Reading Half 2022,2022-04-02,Reading 2,Cambridge,11,9,249.2068104043629,1.0,0,322.79,2,1,0,5.11,2,1,0,5.479649367323063
Reading Half 2022,2022-04-02,Reading 2,Deep,11,6,546.6949863040446,0.9459053029269173,0,156.42000000000002,5,1,0,2.18,5,1,0,2.154742581348824
Reading Half 2022,2022-04-02,Reading 2,Thundering Herd Masters,13,2,600.0,1.0,0,531.63,11,1,0,6.58,11,1,0,6.435973192061862
Reading Half 2022,2022-04-02,Reading 3,Cambridge Ultimate 2,11,8,365.60925011032475,1.0,0,297.70000000000005,3,1,0,3.31,3,1,0,3.5104676459954156
Reading Half 2022,2022-04-02,Reading 3,Thundering Herd,10,9,125.0,1.0,0,-105.97,1,1,0,-1.75,1,1,0,-2.0628458203046875
Reading Half 2022,2022-04-02,Space,Cambridge,13,9,418.5661446562001,1.0,0,263.14,4,1,0,4.11,4,1,0,4.269959158062079
Reading Half 2022,2022-04-02,St Albans,Sharkbear!,11,3,600.0,0.9176629354822471,0,294.45,8,1,0,5.6899999999999995,8,1,0,5.799046344852812
Reading Half 2022,2022-04-02,Thundering Herd,Sharkbear!,13,2,600.0,1.0,1,839.27,11,1,0,12.19,11,1,0,10.826334421255027
Reading Half 2022,2022-04-02,Zoo,Reading 3,8,7,125.0,0.8885233166386386,0,-185.82999999999998,1,1,0,-1.62,1,1,0,-1.9272880730151947
Reading Half 2022,2022-04-02,Zoo,Sharkbear!,13,1,600.0,1.0,0,547.47,12,1,0,8.82,12,1,0,8.511203612683314
Uni Fans 2022,2022-04-09,Bristol Mixed,Black Sheep,12,4,600.0,0.9459053029269173,0,211.17000000000002,8,1,0,3.0500000000000003,8,1,0,3.962745724164538
Uni Fans 2022,2022-04-09,Bristol Mixed,Plymouth Mixed,11,1,600.0,0.9176629354822471,0,225.25999999999993,10,1,0,3.68,10,1,0,4.229260834423982
Uni Fans 2022,2022-04-09,Glasgow,Black Sheep,11,2,600.0,0.9176629354822471,1,689.88,9,1,0,8.26,9,1,0,8.905393970102924
Uni Fans 2022,2022-04-09,Glasgow,Bristol Mixed,10,7,389.6652919127421,0.9459053029269173,0,478.71000000000004,3,1,0,5.21,3,1,0,5.862077658239706
Uni Fans 2022,2022-04-09,Glasgow,MCP,5,4,125.0,0.6882472016116853,0,8.97999999999999,1,1,0,0.3600000000000001,1,1,0,0.5120509603574135
Uni Fans 2022,2022-04-09,Lemmings,MCP,10,2,600.0,0.8583950752789521,0,297.84,8,1,0,3.79,8,1,0,4.574003614518027
Uni Fans 2022,2022-04-09,Lemmings,Plymouth Mixed,11,3,600.0,0.9176629354822471,1,992.8299999999999,8,1,0,12.32,8,1,0,11.31768656290183
Uni Fans 2022,2022-04-09,Lemmings,Sheffield Steal,10,4,600.0,0.8583950752789521,0,486.7,6,1,0,5.64,6,1,0,6.5923676723602185
Uni Fans 2022,2022-04-09,MCP,Black Sheep,10,4,600.0,0.8583950752789521,0,680.9000000000001,6,1,0,7.9,6,1,0,8.566967475405814
Uni Fans 2022,2022-04-09,Sheffield Steal,Glasgow,7,6,125.0,0.8271701918685112,0,-197.83999999999997,1,1,0,-2.21,1,1,0,-2.827768363329856
Uni Fans 2022,2022-04-09,Sheffield Steal,Plymouth Mixed,11,2,600.0,0.9176629354822471,0,506.12999999999994,9,1,0,6.680000000000001,9,1,0,7.069613883703749
Uni Fans 2022,2022-04-10,Glasgow,Plymouth Mixed,10,4,600.0,0.8583950752789521,1,703.9699999999999,6,1,0,8.89,6,1,0,9.08975803422721
Uni Fans 2022,2022-04-10,Lemmings,Black Sheep,13,4,600.0,1.0,1,978.74,9,1,0,11.690000000000001,9,1,0,11.19183408518155
Uni Fans 2022,2022-04-10,Lemmings,Bristol Mixed,13,3,600.0,1.0,1,767.5699999999999,10,1,0,8.64,10,1,0,9.003866132003537
Uni Fans 2022,2022-04-10,Lemmings,Glasgow,13,7,557.5316737222639,1.0,0,288.86,6,1,0,3.4299999999999997,6,1,0,4.104680055645151
Uni Fans 2022,2022-04-10,MCP,Bristol Mixed,10,5,573.8977938505714,0.8885233166386386,0,469.73,5,1,0,4.85,5,1,0,5.422365451009277
Uni Fans 2022,2022-04-10,MCP,Plymouth Mixed,13,4,600.0,1.0,0,694.99,9,1,0,8.530000000000001,9,1,0,8.758896301707633
Uni Fans 2022,2022-04-10,MCP,Sheffield Steal,13,5,600.0,1.0,0,188.86,8,1,0,1.8499999999999999,8,1,0,2.330716459483522
Uni Fans 2022,2022-04-10,Plymouth Mixed,Black Sheep,13,11,228.8403622143806,1.0,0,-14.089999999999918,2,1,0,-0.6299999999999999,2,1,0,-0.28796461577760724
Uni Fans 2022,2022-04-10,Sheffield Steal,Black Sheep,13,6,600.0,1.0,0,492.04,7,1,0,6.050000000000001,7,1,0,6.843569846707453
Uni Fans 2022,2022-04-10,Sheffield Steal,Bristol Mixed,13,10,328.14240231865136,1.0,0,280.87,3,1,0,3.0,3,1,0,3.2756378792847087
Grey Towers 2022,2022-06-18,Black Sheep,The Brown,6,5,125.0,0.7608859102526822,0,-54.210000000000036,1,1,0,-1.3800000000000008,1,1,0,-1.843877514554606
Grey Towers 2022,2022-06-18,Glasgow,Black Sheep,8,3,600.0,0.7608859102526822,1,689.88,5,1,0,8.26,5,1,0,8.905393970102924
Grey Towers 2022,2022-06-18,Glasgow,Nemesis,6,5,125.0,0.7608859102526822,0,454.62,1,1,0,6.220000000000001,1,1,0,6.634661935790859
Grey Towers 2022,2022-06-18,Glasgow,The Brown,7,5,328.14240231865136,0.7947194142390263,0,635.67,2,1,0,6.88,2,1,0,7.617435390553116
Grey Towers 2022,2022-06-18,Glasgow,YCU,7,6,125.0,0.8271701918685112,0,82.76999999999998,1,1,0,0.55,1,1,0,0.9773633317172568
Grey Towers 2022,2022-06-18,LLLeeds,Black Sheep,10,5,573.8977938505714,0.8885233166386386,0,853.09,5,1,0,9.88,5,1,0,10.043853894281561
Grey Towers 2022,2022-06-18,LLLeeds,Glasgow,6,3,546.6949863040446,0.6882472016116853,0,163.21,3,1,0,1.6199999999999999,3,1,0,1.8896572799493185
Grey Towers 2022,2022-06-18,LLLeeds,Nemesis,12,0,600.0,0.9459053029269173,0,617.8299999999999,12,1,0,7.84,12,1,0,8.074404863557852
Grey Towers 2022,2022-06-18,LLLeeds,The Brown,10,3,600.0,0.8583950752789521,0,798.88,7,1,0,8.5,7,1,0,8.93544864446228
Grey Towers 2022,2022-06-18,LLLeeds,YCU,8,5,453.6039151898044,0.8271701918685112,0,245.98,3,1,0,2.17,3,1,0,2.843678664178153
Grey Towers 2022,2022-06-18,Nemesis,Black Sheep,8,1,600.0,0.7608859102526822,0,235.26000000000005,7,1,0,2.04,7,1,0,3.079362840259858
Grey Towers 2022,2022-06-18,Nemesis,The Brown,7,4,496.1596377856195,0.7608859102526822,0,181.05,3,1,0,0.6599999999999993,3,1,0,1.267470466247218
Grey Towers 2022,2022-06-18,YCU,Black Sheep,9,2,600.0,0.8271701918685112,0,607.11,7,1,0,7.710000000000001,7,1,0,8.247056301348515
Grey Towers 2022,2022-06-18,YCU,Nemesis,8,2,600.0,0.7608859102526822,0,371.84999999999997,6,1,0,5.67,6,1,0,5.82517964172747
Grey Towers 2022,2022-06-18,YCU,The Brown,9,1,600.0,0.8271701918685112,0,552.9,8,1,0,6.33,8,1,0,6.867303565514614
Moooxed 2022,2022-06-18,Birmingham Ultimate,Bristol Mixed,9,6,418.5661446562001,0.8885233166386386,0,413.53000000000003,3,1,0,4.550000000000001,3,1,0,4.92889328699966
Moooxed 2022,2022-06-18,Birmingham Ultimate,Sharkbear!,15,1,600.0,1.0,1,779.0,14,1,0,12.04,14,1,0,10.563122793706931
Moooxed 2022,2022-06-18,Birmingham Ultimate,South Wales Storm,15,8,564.8086448756737,1.0,0,467.58,7,1,0,6.82,7,1,0,6.96298034719949
Moooxed 2022,2022-06-18,Bristol Mixed,Sharkbear!,15,2,600.0,1.0,0,365.46999999999997,13,1,0,7.49,13,1,0,7.330488395177991
Moooxed 2022,2022-06-18,Bristol Mixed,South Wales Storm,10,8,262.66557693448596,0.9733285267845752,0,54.049999999999955,2,1,0,2.27,2,1,0,2.400194448927703
Moooxed 2022,2022-06-18,Brixton,Curve,10,9,125.0,1.0,0,-126.79999999999998,1,1,0,-2.99,1,1,0,-3.120287115180691
Moooxed 2022,2022-06-18,Cambridge,Hustle,11,7,466.89332573293274,0.9733285267845752,0,7.189999999999998,4,1,0,0.72,4,1,0,0.8518325121110255
Moooxed 2022,2022-06-18,Cambridge,St Albans,14,7,582.8868714046324,1.0,0,353.83,7,1,0,4.45,7,1,0,4.89407457648765
Moooxed 2022,2022-06-18,Curve,Thundering,11,10,125.0,1.0,0,-229.39000000000001,1,1,0,-0.81,1,1,0,-1.3552937812356696
Moooxed 2022,2022-06-18,Herd,Cambridge,11,9,249.2068104043629,1.0,0,279.72,2,1,0,2.49,2,1,0,2.5512139039183808
Moooxed 2022,2022-06-18,Herd,Hustle,14,7,582.8868714046324,1.0,0,286.91,7,1,0,3.21,7,1,0,3.3704918546116076
Moooxed 2022,2022-06-18,Herd,St Albans,14,7,582.8868714046324,1.0,0,633.55,7,1,0,6.94,7,1,0,7.053852014191062
Moooxed 2022,2022-06-18,Hustle,St Albans,11,6,546.6949863040446,0.9459053029269173,0,346.64,5,1,0,3.7300000000000004,5,1,0,4.1185530281893
Moooxed 2022,2022-06-18,Mythago,GU,15,6,600.0,1.0,0,877.34,9,1,0,11.43,9,1,0,10.34995477243217
Moooxed 2022,2022-06-18,Mythago,Oxford Ultimate,12,10,238.1225775586291,1.0,0,213.53000000000003,2,1,0,1.8800000000000003,2,1,0,2.0488635021801187
Moooxed 2022,2022-06-18,Mythago,Zoo,12,7,520.5112660164395,1.0,0,635.58,5,1,0,7.26,5,1,0,7.485296282014492
Moooxed 2022,2022-06-18,Oxford Ultimate,GU,14,3,600.0,1.0,1,663.81,11,1,0,9.549999999999999,11,1,0,9.164854109820357
Moooxed 2022,2022-06-18,Oxford Ultimate,Zoo,14,7,582.8868714046324,1.0,0,422.04999999999995,7,1,0,5.38,7,1,0,5.834093690227871
Moooxed 2022,2022-06-18,South Wales Storm,Sharkbear!,10,8,262.66557693448596,0.9733285267845752,0,311.42,2,1,0,5.22,2,1,0,5.3485402252013365
Moooxed 2022,2022-06-18,Thundering,Brixton,13,10,328.14240231865136,1.0,0,356.19,3,1,0,3.8000000000000003,3,1,0,4.393013605845585
Moooxed 2022,2022-06-18,Zoo,GU,11,6,546.6949863040446,0.9459053029269173,0,241.76000000000002,5,1,0,4.17,5,1,0,4.369002824055759
Moooxed 2022,2022-06-19,Birmingham Ultimate,Curve,14,10,398.70186369942724,1.0,0,155.82999999999998,4,1,0,1.29,4,1,0,1.6404129974836685
Moooxed 2022,2022-06-19,Brixton,GU,12,11,125.0,1.0,0,190.66000000000003,1,1,0,3.1099999999999994,1,1,0,3.118134409943064
Moooxed 2022,2022-06-19,Cambridge,Curve,10,9,125.0,1.0,0,25.11,1,1,0,-0.61,1,1,0,-0.29021378004774157
Moooxed 2022,2022-06-19,Curve,Bristol Mixed,11,10,125.0,1.0,0,257.70000000000005,1,1,0,3.2600000000000002,1,1,0,3.4110573260034016
Moooxed 2022,2022-06-19,GU,St Albans,10,7,389.6652919127421,0.9459053029269173,0,11.259999999999991,3,1,0,-1.0399999999999991,3,1,0,-0.9594383579108499
Moooxed 2022,2022-06-19,Herd,Oxford Ultimate,14,11,313.3379659704299,1.0,0,-41.51999999999998,3,1,0,-1.5699999999999998,3,1,0,-2.0282513725996925
Moooxed 2022,2022-06-19,Herd,Thundering,12,11,125.0,1.0,0,75.44,1,1,0,1.0699999999999998,1,1,0,0.92582165496027
Moooxed 2022,2022-06-19,Hustle,Sharkbear!,14,6,600.0,1.0,0,641.09,8,1,0,9.42,8,1,0,8.965874580336852
Moooxed 2022,2022-06-19,Hustle,South Wales Storm,15,7,600.0,1.0,0,329.66999999999996,8,1,0,4.2,8,1,0,4.597120504391032
Moooxed 2022,2022-06-19,Hustle,Zoo,13,9,418.5661446562001,1.0,0,93.61999999999999,4,1,0,0.6000000000000001,4,1,0,0.688016894225747
Moooxed 2022,2022-06-19,Mythago,Birmingham Ultimate,12,7,520.5112660164395,1.0,0,404.05,5,1,0,4.04,5,1,0,4.589644140541733
Moooxed 2022,2022-06-19,Mythago,Cambridge,15,6,600.0,1.0,0,534.77,9,1,0,5.94,9,1,0,6.269800327082976
Moooxed 2022,2022-06-19,Mythago,Herd,12,8,441.15462425988915,1.0,0,255.05,4,1,0,3.45,4,1,0,4.00317865219413
Moooxed 2022,2022-06-19,Oxford Ultimate,Bristol Mixed,11,9,249.2068104043629,1.0,0,604.05,2,1,0,6.71,2,1,0,7.164342423177601
Moooxed 2022,2022-06-19,Oxford Ultimate,Cambridge,15,9,515.4814780292847,1.0,0,321.24,6,1,0,4.06,6,1,0,4.476515310464649
Moooxed 2022,2022-06-19,Sharkbear!,GU,9,8,125.0,0.9459053029269173,0,-305.71,1,1,0,-4.65,1,1,0,-4.96231676240442
Moooxed 2022,2022-06-19,South Wales Storm,Brixton,10,9,125.0,1.0,0,-184.95,1,1,0,-2.54,1,1,0,-2.696622616252146
Moooxed 2022,2022-06-19,South Wales Storm,St Albans,10,7,389.6652919127421,0.9459053029269173,0,16.970000000000027,3,1,0,-0.46999999999999975,3,1,0,-0.5225384722158815
Moooxed 2022,2022-06-19,St Albans,Sharkbear!,11,10,125.0,1.0,0,294.45,1,1,0,5.6899999999999995,1,1,0,5.799046344852812
Moooxed 2022,2022-06-19,Thundering,Birmingham Ultimate,13,9,418.5661446562001,1.0,0,73.56000000000002,4,1,0,-0.4800000000000001,4,1,0,-0.28796461577760724
Moooxed 2022,2022-06-19,Thundering,Bristol Mixed,11,5,600.0,0.9176629354822471,0,487.09000000000003,6,1,0,4.07,6,1,0,4.670390467007799
Moooxed 2022,2022-06-19,Zoo,Brixton,15,9,515.4814780292847,1.0,0,51.099999999999994,6,1,0,1.06,6,1,0,1.3314862874271434
YDG 2022,2022-07-09,Brighton Mixed,Brixton,15,4,600.0,1.0,0,497.78999999999996,11,1,0,6.76,11,1,0,6.904004989011806
YDG 2022,2022-07-09,Brighton Mixed,Norwich Ultimate,15,4,600.0,1.0,0,276.97999999999996,11,1,0,4.67,11,1,0,4.914839022359082
YDG 2022,2022-07-09,Brighton Mixed,St Albans,14,10,398.70186369942724,1.0,0,699.71,4,1,0,8.83,4,1,0,8.519844476507323
YDG 2022,2022-07-09,Bristol Mixed,Black Sheep,13,10,328.14240231865136,1.0,0,211.17000000000002,3,1,0,3.0500000000000003,3,1,0,3.962745724164538
YDG 2022,2022-07-09,Bristol Mixed,Plymouth Mixed,11,10,125.0,1.0,0,225.25999999999993,1,1,0,3.68,1,1,0,4.229260834423982
YDG 2022,2022-07-09,Cambridge,Purple Cobras,10,7,389.6652919127421,0.9459053029269173,0,-112.93,3,1,0,-1.0,3,1,0,-1.0453029651719152
YDG 2022,2022-07-09,Curve,Black Sheep,15,6,600.0,1.0,0,468.87,9,1,0,6.3100000000000005,9,1,0,6.95591770477801
YDG 2022,2022-07-09,Curve,Bristol Mixed,15,6,600.0,1.0,0,257.70000000000005,9,1,0,3.2600000000000002,9,1,0,3.4110573260034016
YDG 2022,2022-07-09,Curve,Plymouth Mixed,15,4,600.0,1.0,0,482.9599999999999,11,1,0,6.94,11,1,0,7.179962839575044
YDG 2022,2022-07-09,Deep Space,Cambridge,15,2,600.0,1.0,1,710.4,13,1,0,9.28,13,1,0,9.231307296471257
YDG 2022,2022-07-09,Deep Space,Purple Cobras,15,4,600.0,1.0,0,597.4699999999999,11,1,0,8.28,11,1,0,8.552806168469615
YDG 2022,2022-07-09,Deep Space,SMOG Rising,10,8,262.66557693448596,0.9733285267845752,0,326.30999999999995,2,1,0,2.7699999999999996,2,1,0,3.1826567889230226
YDG 2022,2022-07-09,Flyght Club,GU,11,10,125.0,1.0,0,218.45000000000002,1,1,0,3.3799999999999994,1,1,0,3.5621745577304935
YDG 2022,2022-07-09,Flyght Club,Zootopia,12,7,520.5112660164395,1.0,0,415.97,5,1,0,4.74,5,1,0,4.953631961567297
YDG 2022,2022-07-09,GU,Zootopia,11,6,546.6949863040446,0.9459053029269173,0,197.52000000000004,5,1,0,1.3600000000000003,5,1,0,1.5098694287663896
YDG 2022,2022-07-09,Herd,South Wales Storm,14,6,600.0,1.0,1,616.5799999999999,8,1,0,7.41,8,1,0,7.454275895212994
YDG 2022,2022-07-09,Herd,Zoolander,15,12,300.4922431832018,1.0,0,315.06,3,1,0,3.56,3,1,0,3.867695290018421
YDG 2022,2022-07-09,Horsham Ultimate,Herd,15,4,600.0,1.0,0,160.58999999999997,11,1,0,3.1900000000000004,11,1,0,3.551557123042464
YDG 2022,2022-07-09,Horsham Ultimate,South Wales Storm,15,7,600.0,1.0,0,777.17,8,1,0,10.600000000000001,8,1,0,9.847179455475459
YDG 2022,2022-07-09,Horsham Ultimate,Zoolander,15,5,600.0,1.0,0,475.65,10,1,0,6.75,10,1,0,6.992365668525032
YDG 2022,2022-07-09,Lemmings,Oxford Ultimate,15,12,300.4922431832018,1.0,0,163.51999999999998,3,1,0,1.9300000000000002,3,1,0,2.578880495694481
YDG 2022,2022-07-09,Lemmings,Thundering,12,6,579.3107485100336,0.9733285267845752,0,280.47999999999996,6,1,0,4.57,6,1,0,5.329545749863069
YDG 2022,2022-07-09,Mixed Feelings,Flyght Club,11,8,365.60925011032475,1.0,0,220.12,3,1,0,3.27,3,1,0,3.3982528275728043
YDG 2022,2022-07-09,Mixed Feelings,GU,15,2,600.0,1.0,0,438.57,13,1,0,6.6499999999999995,13,1,0,6.605069654355827
YDG 2022,2022-07-09,Mixed Feelings,Zootopia,15,5,600.0,1.0,1,636.09,10,1,0,8.01,10,1,0,7.770522162863056
YDG 2022,2022-07-09,Norwich Ultimate,Brixton,12,8,441.15462425988915,1.0,0,220.80999999999997,4,1,0,2.09,4,1,0,2.3424252820971
YDG 2022,2022-07-09,Norwich Ultimate,St Albans,14,8,536.0348119187572,1.0,0,422.73,6,1,0,4.16,6,1,0,4.429325925111712
YDG 2022,2022-07-09,Oxford Ultimate,Thundering,15,12,300.4922431832018,1.0,0,116.95999999999998,3,1,0,2.6399999999999997,3,1,0,2.9296230570211605
YDG 2022,2022-07-09,Plymouth Mixed,Black Sheep,13,9,418.5661446562001,1.0,0,-14.089999999999918,4,1,0,-0.6299999999999999,4,1,0,-0.28796461577760724
YDG 2022,2022-07-09,Reading,Lemmings,15,6,600.0,1.0,0,305.1,9,1,0,4.44,9,1,0,5.0329914953392105
YDG 2022,2022-07-09,Reading,Oxford Ultimate,15,4,600.0,1.0,0,468.62,11,1,0,6.370000000000001,11,1,0,7.196717851714162
YDG 2022,2022-07-09,Reading,Thundering,15,4,600.0,1.0,0,585.5799999999999,11,1,0,9.01,11,1,0,9.258748048348654
YDG 2022,2022-07-09,SMOG Rising,Cambridge,15,13,214.17926913507503,1.0,0,384.09000000000003,2,1,0,6.510000000000001,2,1,0,6.957095084901589
YDG 2022,2022-07-09,SMOG Rising,Purple Cobras,15,1,600.0,1.0,0,271.16,14,1,0,5.510000000000001,14,1,0,6.109250484071577
YDG 2022,2022-07-09,St Albans,Brixton,15,8,564.8086448756737,1.0,0,-201.92000000000002,7,1,0,-2.0700000000000003,7,1,0,-2.187785408432312
YDG 2022,2022-07-09,Zoolander,South Wales Storm,14,8,536.0348119187572,1.0,0,301.52,6,1,0,3.85,6,1,0,4.113698353033076
YDG 2022,2022-07-10,Brighton Mixed,Cambridge,11,7,466.89332573293274,0.9733285267845752,0,345.88,4,1,0,4.38,4,1,0,4.450538909761697
YDG 2022,2022-07-10,Brighton Mixed,Purple Cobras,11,7,466.89332573293274,0.9733285267845752,0,232.95,4,1,0,3.38,4,1,0,3.4771300359214585
YDG 2022,2022-07-10,Brixton,GU,12,6,579.3107485100336,0.9733285267845752,0,190.66000000000003,6,1,0,3.1099999999999994,6,1,0,3.118134409943064
YDG 2022,2022-07-10,Brixton,Plymouth Mixed,14,7,582.8868714046324,1.0,0,356.15999999999997,7,1,0,3.95,7,1,0,4.5086032744474664
YDG 2022,2022-07-10,Brixton,Zoolander,10,7,389.6652919127421,0.9459053029269173,0,-116.57,3,1,0,-1.31,3,1,0,-1.4905644879800128
YDG 2022,2022-07-10,Cambridge,Curve,14,12,220.95664314305532,1.0,0,25.11,2,1,0,-0.61,2,1,0,-0.29021378004774157
YDG 2022,2022-07-10,Deep Space,SMOG Rising,15,8,564.8086448756737,1.0,0,326.30999999999995,7,1,0,2.7699999999999996,7,1,0,3.1826567889230226
YDG 2022,2022-07-10,Flyght Club,Bristol Mixed,8,7,125.0,0.8885233166386386,0,158.69000000000003,1,1,0,0.54,1,1,0,0.7718177693943087
YDG 2022,2022-07-10,Flyght Club,Norwich Ultimate,11,10,125.0,1.0,0,-193.01999999999998,1,1,0,-1.82,1,1,0,-1.8844903711157706
YDG 2022,2022-07-10,GU,South Wales Storm,11,8,365.60925011032475,1.0,0,-5.710000000000036,3,1,0,-0.5699999999999994,3,1,0,-0.43787555700186154
YDG 2022,2022-07-10,Herd,Bristol Mixed,15,9,515.4814780292847,1.0,0,562.53,6,1,0,5.140000000000001,6,1,0,5.490694430114971
YDG 2022,2022-07-10,Herd,Flyght Club,13,7,557.5316737222639,1.0,0,403.84000000000003,6,1,0,4.6,6,1,0,4.809461598683804
YDG 2022,2022-07-10,Herd,Norwich Ultimate,11,10,125.0,1.0,0,210.82000000000002,1,1,0,2.7800000000000002,1,1,0,3.047739371933119
YDG 2022,2022-07-10,Horsham Ultimate,Cambridge,13,8,496.1596377856195,1.0,0,440.31,5,1,0,5.680000000000001,5,1,0,5.866525224107651
YDG 2022,2022-07-10,Horsham Ultimate,Mixed Feelings,10,7,389.6652919127421,0.9459053029269173,0,344.31,3,1,0,4.5200000000000005,3,1,0,4.954300155634744
YDG 2022,2022-07-10,Lemmings,Deep Space,13,12,125.0,1.0,0,-225.64,1,1,0,-3.29,1,1,0,-3.477839726250961
YDG 2022,2022-07-10,Mixed Feelings,Purple Cobras,10,8,262.66557693448596,0.9733285267845752,0,-16.930000000000003,2,1,0,0.16,2,1,0,0.0022499999831246953
YDG 2022,2022-07-10,Norwich Ultimate,Bristol Mixed,12,6,579.3107485100336,0.9733285267845752,0,351.71000000000004,6,1,0,2.3600000000000003,6,1,0,2.6392470720331502
YDG 2022,2022-07-10,Oxford Ultimate,Curve,15,11,381.1647521399218,1.0,0,346.35,4,1,0,3.4499999999999997,4,1,0,4.2106135462186
YDG 2022,2022-07-10,Oxford Ultimate,Mixed Feelings,13,9,418.5661446562001,1.0,0,225.23999999999998,4,1,0,2.9,4,1,0,3.5019593876215183
YDG 2022,2022-07-10,Oxford Ultimate,Thundering,15,0,600.0,1.0,0,116.95999999999998,15,1,0,2.6399999999999997,15,1,0,2.9296230570211605
YDG 2022,2022-07-10,Plymouth Mixed,Black Sheep,12,10,238.1225775586291,1.0,0,-14.089999999999918,2,1,0,-0.6299999999999999,2,1,0,-0.28796461577760724
YDG 2022,2022-07-10,Purple Cobras,Curve,10,9,125.0,1.0,0,138.04000000000002,1,1,0,0.39,1,1,0,0.7561086256325193
YDG 2022,2022-07-10,Reading,Lemmings,15,9,515.4814780292847,1.0,0,305.1,6,1,0,4.44,6,1,0,5.0329914953392105
YDG 2022,2022-07-10,Reading,SMOG Rising,15,11,381.1647521399218,1.0,0,405.77,4,1,0,3.92,4,1,0,4.75556100295972
YDG 2022,2022-07-10,South Wales Storm,Plymouth Mixed,12,7,520.5112660164395,1.0,0,171.20999999999998,5,1,0,1.4100000000000001,5,1,0,1.9154849657373774
YDG 2022,2022-07-10,South Wales Storm,Zootopia,12,10,238.1225775586291,1.0,0,203.23000000000008,2,1,0,1.9299999999999997,2,1,0,1.9420385435835463
YDG 2022,2022-07-10,St Albans,Black Sheep,13,8,496.1596377856195,1.0,0,140.15000000000003,5,1,0,1.25,5,1,0,2.1459275392644415
YDG 2022,2022-07-10,St Albans,GU,11,9,249.2068104043629,1.0,0,-11.259999999999991,2,1,0,1.0399999999999991,2,1,0,0.9594383579108516
YDG 2022,2022-07-10,Thundering,Brighton Mixed,13,10,328.14240231865136,1.0,0,-141.59999999999997,3,1,0,-2.96,3,1,0,-2.9022000546316775
YDG 2022,2022-07-10,Thundering,Horsham Ultimate,10,8,262.66557693448596,0.9733285267845752,0,-236.02999999999997,2,1,0,-4.260000000000001,2,1,0,-4.41288962311412
YDG 2022,2022-07-10,Zoolander,St Albans,15,7,600.0,1.0,0,318.49,8,1,0,3.3800000000000003,8,1,0,3.625799409141326
YDG 2022,2022-07-10,Zoolander,Zootopia,12,6,579.3107485100336,0.9733285267845752,0,504.75000000000006,6,1,0,5.779999999999999,6,1,0,5.848091674834414
YDG 2022,2022-07-10,Zootopia,Black Sheep,13,8,496.1596377856195,1.0,0,-46.110000000000014,5,1,0,-1.1499999999999995,5,1,0,-0.31495370316674354
Regionals North 2022,2022-08-13,Birmingham Ultimate,Nemesis,12,6,579.3107485100336,0.9733285267845752,0,389.44,6,1,0,5.5600000000000005,6,1,0,5.745375616287209
Regionals North 2022,2022-08-13,Black Sheep,Cambridge,12,10,238.1225775586291,1.0,0,-493.98,2,1,0,-5.7,2,1,0,-6.726050141385407
Regionals North 2022,2022-08-13,Glasgow,Black Sheep,15,4,600.0,1.0,1,689.88,11,1,0,8.26,11,1,0,8.905393970102924
Regionals North 2022,2022-08-13,Glasgow,Cambridge,15,4,600.0,1.0,0,195.89999999999998,11,1,0,2.56,11,1,0,2.9699987691563123
Regionals North 2022,2022-08-13,Lemmings,Birmingham Ultimate,14,4,600.0,1.0,0,354.03999999999996,10,1,0,4.09,10,1,0,5.076205834683343
Regionals North 2022,2022-08-13,Lemmings,Nemesis,14,3,600.0,1.0,1,743.48,11,1,0,9.65,11,1,0,9.57983440692713
Regionals North 2022,2022-08-13,Lemmings,SMOG Rising,11,7,466.89332573293274,0.9733285267845752,0,100.66999999999996,4,1,0,-0.5200000000000005,4,1,0,-0.3104556588848766
Regionals North 2022,2022-08-13,SMOG,Black Sheep,15,1,600.0,1.0,0,1269.63,14,1,0,18.490000000000002,14,1,0,13.678651260305884
Regionals North 2022,2022-08-13,SMOG,Cambridge,15,2,600.0,1.0,0,775.65,13,1,0,12.79,13,1,0,11.762210521359428
Regionals North 2022,2022-08-13,SMOG,Glasgow,14,5,600.0,1.0,0,579.75,9,1,0,10.23,9,1,0,10.408200573591426
Regionals North 2022,2022-08-13,SMOG Rising,Birmingham Ultimate,12,7,520.5112660164395,1.0,0,253.37,5,1,0,4.61,5,1,0,5.34919485725457
Regionals North 2022,2022-08-13,SMOG Rising,Nemesis,15,4,600.0,1.0,1,642.81,11,1,0,10.170000000000002,11,1,0,9.761262924493781
Regionals South 2022,2022-08-13,Brighton,Guildford,7,5,328.14240231865136,0.7947194142390263,0,275.8,2,1,0,1.2200000000000002,2,1,0,1.8497865601102603
Regionals South 2022,2022-08-13,Brighton,Thundering Herd 2,9,5,529.0591339672189,0.8583950752789521,0,394.77,4,1,0,2.35,4,1,0,3.2127252444689667
Regionals South 2022,2022-08-13,Deep Space,Brighton,14,4,600.0,1.0,1,725.3499999999999,10,1,0,10.129999999999999,10,1,0,9.71744766603917
Regionals South 2022,2022-08-13,Deep Space,Guildford,13,3,600.0,1.0,1,1001.15,10,1,0,11.35,10,1,0,10.711495070528198
Regionals South 2022,2022-08-13,Deep Space,Oxford Ultimate,14,5,600.0,1.0,0,389.15999999999997,9,1,0,5.220000000000001,9,1,0,5.824542738420607
Regionals South 2022,2022-08-13,Deep Space,Zoo,15,1,600.0,1.0,1,811.2099999999999,14,1,0,10.6,14,1,0,10.128904920960434
Regionals South 2022,2022-08-13,Guildford,Thundering Herd 2,9,7,279.3368557106305,0.9176629354822471,0,118.96999999999997,2,1,0,1.13,2,1,0,1.3999141883757744
Regionals South 2022,2022-08-13,Mixed Feelings,Bristol Mixed,7,4,496.1596377856195,0.7608859102526822,0,378.81,3,1,0,3.81,3,1,0,4.122020082145546
Regionals South 2022,2022-08-13,Oxford Ultimate,Brighton,13,4,600.0,1.0,0,336.19,9,1,0,4.91,9,1,0,5.201318244349256
Regionals South 2022,2022-08-13,Oxford Ultimate,Thundering Herd 2,12,2,600.0,0.9459053029269173,1,730.96,10,1,0,7.26,10,1,0,7.832347034454013
Regionals South 2022,2022-08-13,Oxford Ultimate,Zoo,10,4,600.0,0.8583950752789521,0,422.04999999999995,6,1,0,5.38,6,1,0,5.834093690227871
Regionals South 2022,2022-08-13,Purple Cobras,Bristol Mixed,12,3,600.0,0.9459053029269173,0,395.74,9,1,0,3.6500000000000004,9,1,0,4.11993990691148
Regionals South 2022,2022-08-13,Purple Cobras,Mixed Feelings,9,6,418.5661446562001,0.8885233166386386,0,16.930000000000003,3,1,0,-0.16,3,1,0,-0.0022499999831246953
Regionals South 2022,2022-08-13,Reading,Bristol Mixed,15,2,600.0,1.0,1,1072.67,13,1,0,13.08,13,1,0,11.683690594957728
Regionals South 2022,2022-08-13,Reading,Mixed Feelings,15,3,600.0,1.0,1,693.86,12,1,0,9.27,12,1,0,9.621012122222211
Regionals South 2022,2022-08-13,Reading,Purple Cobras,9,8,125.0,0.9459053029269173,0,676.93,1,1,0,9.43,1,1,0,9.622336356065023
Regionals South 2022,2022-08-13,Reading,Thundering Herd,13,4,600.0,1.0,0,598.87,9,1,0,8.38,9,1,0,8.73166766180476
Regionals South 2022,2022-08-13,Thundering Herd,Bristol Mixed,12,5,600.0,0.9459053029269173,0,473.8,7,1,0,4.7,7,1,0,5.400836854774941
Regionals South 2022,2022-08-13,Thundering Herd,Mixed Feelings,8,6,300.4922431832018,0.8583950752789521,0,94.99000000000001,2,1,0,0.89,2,1,0,1.4192419866816444
Regionals South 2022,2022-08-13,Thundering Herd,Purple Cobras,9,4,600.0,0.8271701918685112,0,78.06,5,1,0,1.05,5,1,0,1.4214718125401298
Regionals South 2022,2022-08-13,Zoo,Guildford,9,5,529.0591339672189,0.8583950752789521,0,189.94000000000003,4,1,0,0.75,4,1,0,1.125132726232529
Regionals South 2022,2022-08-13,Zoo,Thundering Herd 2,7,5,328.14240231865136,0.7947194142390263,0,308.90999999999997,2,1,0,1.88,2,1,0,2.507493465518259
Regionals North 2022,2022-08-14,Birmingham Ultimate,Cambridge,14,7,582.8868714046324,1.0,0,130.72,7,1,0,1.9000000000000001,7,1,0,1.926550449741491
Regionals North 2022,2022-08-14,Birmingham Ultimate,Nemesis,12,4,600.0,0.9459053029269173,0,389.44,8,1,0,5.5600000000000005,8,1,0,5.745375616287209
Regionals North 2022,2022-08-14,Black Sheep,Cambridge,11,7,466.89332573293274,0.9733285267845752,0,-493.98,4,1,0,-5.7,4,1,0,-6.726050141385407
Regionals North 2022,2022-08-14,Glasgow,Lemmings,12,7,520.5112660164395,1.0,0,-288.86,5,1,0,-3.4299999999999997,5,1,0,-4.104680055645153
Regionals North 2022,2022-08-14,Lemmings,SMOG Rising,13,12,125.0,1.0,0,100.66999999999996,1,1,0,-0.5200000000000005,1,1,0,-0.3104556588848766
Regionals North 2022,2022-08-14,Nemesis,Black Sheep,11,9,249.2068104043629,1.0,0,235.26000000000005,2,1,0,2.04,2,1,0,3.079362840259858
Regionals North 2022,2022-08-14,SMOG,Glasgow,15,3,600.0,1.0,0,579.75,12,1,0,10.23,12,1,0,10.408200573591426
Regionals North 2022,2022-08-14,SMOG,SMOG Rising,15,7,600.0,1.0,0,391.55999999999995,8,1,0,6.279999999999999,8,1,0,7.551562079154042
Regionals South 2022,2022-08-14,Brighton,Zoo,10,6,496.1596377856195,0.9176629354822471,0,85.85999999999999,4,1,0,0.4700000000000002,4,1,0,0.7314194816216055
Regionals South 2022,2022-08-14,Deep Space,Purple Cobras,10,5,573.8977938505714,0.8885233166386386,0,597.4699999999999,5,1,0,8.28,5,1,0,8.552806168469615
Regionals South 2022,2022-08-14,Deep Space,Reading,9,8,125.0,0.9459053029269173,0,-79.46000000000004,1,1,0,-1.1500000000000004,1,1,0,-1.6863411491997837
Regionals South 2022,2022-08-14,Deep Space,Thundering Herd,12,4,600.0,0.9459053029269173,0,519.41,8,1,0,7.23,8,1,0,7.5386766249815444
Regionals South 2022,2022-08-14,Deep Space,Thundering Herd 2,10,4,600.0,0.8583950752789521,1,1120.12,6,1,0,12.48,6,1,0,11.354674507211143
Regionals South 2022,2022-08-14,Guildford,Bristol Mixed,6,5,125.0,0.7608859102526822,0,-7.939999999999998,1,1,0,0.5800000000000001,1,1,0,0.512800085090868
Regionals South 2022,2022-08-14,Mixed Feelings,Guildford,10,4,600.0,0.8583950752789521,0,386.75,6,1,0,3.23,6,1,0,3.64344853215448
Regionals South 2022,2022-08-14,Mixed Feelings,Thundering Herd 2,12,4,600.0,0.9459053029269173,0,505.71999999999997,8,1,0,4.36,8,1,0,4.931569191253569
Regionals South 2022,2022-08-14,Mixed Feelings,Zoo,8,4,564.8086448756737,0.7947194142390263,0,196.81,4,1,0,2.48,4,1,0,2.565049447067995
Regionals South 2022,2022-08-14,Oxford Ultimate,Guildford,8,6,300.4922431832018,0.8583950752789521,0,611.99,2,1,0,6.13,2,1,0,6.761953785631363
Regionals South 2022,2022-08-14,Oxford Ultimate,Purple Cobras,9,5,529.0591339672189,0.8583950752789521,0,208.31,4,1,0,3.0599999999999996,4,1,0,3.5040866759132676
Regionals South 2022,2022-08-14,Oxford Ultimate,Thundering Herd,7,6,125.0,0.8271701918685112,0,130.25,1,1,0,2.01,1,1,0,2.129762702322825
Regionals South 2022,2022-08-14,Purple Cobras,Brighton,6,4,365.60925011032475,0.7254762501100116,0,127.88000000000001,2,1,0,1.8499999999999999,2,1,0,1.8468321100858667
Regionals South 2022,2022-08-14,Reading,Brighton,15,1,600.0,1.0,1,804.81,14,1,0,11.280000000000001,14,1,0,10.629624659506199
Regionals South 2022,2022-08-14,Reading,Oxford Ultimate,8,4,564.8086448756737,0.7947194142390263,0,468.62,4,1,0,6.370000000000001,4,1,0,7.196717851714162
Regionals South 2022,2022-08-14,Thundering Herd,Brighton,7,5,328.14240231865136,0.7947194142390263,0,205.94,2,1,0,2.9,2,1,0,3.2306103132114714
Regionals South 2022,2022-08-14,Thundering Herd 2,Bristol Mixed,8,6,300.4922431832018,0.8583950752789521,0,-126.90999999999997,2,1,0,-0.5499999999999998,2,1,0,-0.8899535539505408
Regionals South 2022,2022-08-14,Zoo,Bristol Mixed,6,4,365.60925011032475,0.7254762501100116,0,182.00000000000003,2,1,0,1.33,2,1,0,1.6337433983510223
Nationals 2022,2022-09-03,Birmingham Ultimate,Nemesis,15,7,600.0,1.0,0,389.44,8,1,0,5.5600000000000005,8,1,0,5.745375616287209
Nationals 2022,2022-09-03,Deep Space,Birmingham Ultimate,11,3,600.0,0.9176629354822471,0,579.68,8,1,0,7.38,8,1,0,7.931698733409743
Nationals 2022,2022-09-03,Deep Space,SMOG Rising,13,11,228.8403622143806,1.0,0,326.30999999999995,2,1,0,2.7699999999999996,2,1,0,3.1826567889230226
Nationals 2022,2022-09-03,Deep Space,Thundering Herd,15,8,564.8086448756737,1.0,0,519.41,7,1,0,7.23,7,1,0,7.5386766249815444
Nationals 2022,2022-09-03,Glasgow,Nemesis,15,4,600.0,1.0,0,454.62,11,1,0,6.220000000000001,11,1,0,6.634661935790859
Nationals 2022,2022-09-03,Lemmings,Black Sheep,15,2,600.0,1.0,1,978.74,13,1,0,11.690000000000001,13,1,0,11.19183408518155
Nationals 2022,2022-09-03,Lemmings,Oxford Ultimate,13,12,125.0,1.0,0,163.51999999999998,1,1,0,1.9300000000000002,1,1,0,2.578880495694481
Nationals 2022,2022-09-03,Oxford Ultimate,Glasgow,13,6,600.0,1.0,0,125.34,7,1,0,1.4999999999999998,7,1,0,1.6011271061617691
Nationals 2022,2022-09-03,Oxford Ultimate,Nemesis,14,8,536.0348119187572,1.0,0,579.96,6,1,0,7.720000000000001,6,1,0,7.864482794063964
Nationals 2022,2022-09-03,Purple Cobras,Black Sheep,14,10,398.70186369942724,1.0,0,606.9100000000001,4,1,0,6.7,4,1,0,7.535873466925839
Nationals 2022,2022-09-03,Reading,Black Sheep,15,3,600.0,1.0,1,1283.8400000000001,12,1,0,16.130000000000003,12,1,0,12.976242998469544
Nationals 2022,2022-09-03,Reading,Glasgow,15,6,600.0,1.0,0,593.96,9,1,0,7.87,9,1,0,8.369233803826003
Nationals 2022,2022-09-03,Reading,Lemmings,15,6,600.0,1.0,0,305.1,9,1,0,4.44,9,1,0,5.0329914953392105
Nationals 2022,2022-09-03,SMOG,Purple Cobras,15,2,600.0,1.0,0,662.7199999999999,13,1,0,11.79,13,1,0,11.336381531992558
Nationals 2022,2022-09-03,SMOG,SMOG Rising,14,10,398.70186369942724,1.0,0,391.55999999999995,4,1,0,6.279999999999999,4,1,0,7.551562079154042
Nationals 2022,2022-09-03,SMOG,Thundering Herd,15,5,600.0,1.0,0,584.66,10,1,0,10.74,10,1,0,10.679788931137306
Nationals 2022,2022-09-03,SMOG Rising,Purple Cobras,15,2,600.0,1.0,0,271.16,13,1,0,5.510000000000001,13,1,0,6.109250484071577
Nationals 2022,2022-09-03,Thundering Herd,Birmingham Ultimate,12,6,579.3107485100336,0.9733285267845752,0,60.27000000000001,6,1,0,0.1499999999999999,6,1,0,0.5352726194519892
Nationals 2022,2022-09-04,Birmingham Ultimate,Black Sheep,15,3,600.0,1.0,1,624.7,12,1,0,7.6000000000000005,12,1,0,8.181420754972166
Nationals 2022,2022-09-04,Birmingham Ultimate,Purple Cobras,10,9,125.0,1.0,0,17.789999999999992,1,1,0,0.9000000000000001,1,1,0,0.8892061917918674
Nationals 2022,2022-09-04,Deep Space,Lemmings,11,8,365.60925011032475,1.0,0,225.64,3,1,0,3.29,3,1,0,3.4778397262509593
Nationals 2022,2022-09-04,Glasgow,SMOG Rising,12,10,238.1225775586291,1.0,0,-188.19000000000003,2,1,0,-3.95,2,1,0,-4.390270759471219
Nationals 2022,2022-09-04,Lemmings,Oxford Ultimate,11,9,249.2068104043629,1.0,0,163.51999999999998,2,1,0,1.9300000000000002,2,1,0,2.578880495694481
Nationals 2022,2022-09-04,Nemesis,Black Sheep,14,10,398.70186369942724,1.0,0,235.26000000000005,4,1,0,2.04,4,1,0,3.079362840259858
Nationals 2022,2022-09-04,Oxford Ultimate,Glasgow,12,11,125.0,1.0,0,125.34,1,1,0,1.4999999999999998,1,1,0,1.6011271061617691
Nationals 2022,2022-09-04,Oxford Ultimate,Thundering Herd,13,12,125.0,1.0,0,130.25,1,1,0,2.01,1,1,0,2.129762702322825
Nationals 2022,2022-09-04,Purple Cobras,Nemesis,11,7,466.89332573293274,0.9733285267845752,0,371.65,4,1,0,4.66,4,1,0,4.96899483763541
Nationals 2022,2022-09-04,Reading,Deep Space,14,9,473.8676990361691,1.0,0,79.46000000000004,5,1,0,1.1500000000000004,5,1,0,1.6863411491997837
Nationals 2022,2022-09-04,SMOG,Lemmings,15,5,600.0,1.0,0,290.89,10,1,0,6.8,10,1,0,7.780942900408629
Nationals 2022,2022-09-04,SMOG,Reading,14,11,313.3379659704299,1.0,0,-14.210000000000036,3,1,0,2.3599999999999994,3,1,0,3.3270221085904446
Nationals 2022,2022-09-04,SMOG Rising,Thundering Herd,15,9,515.4814780292847,1.0,0,193.10000000000002,6,1,0,4.460000000000001,6,1,0,4.875972290967024
