Tournament,Date,Team_1,Team_2,Score_1,Score_2,Game_Rank_Diff_USAU,Game_Wght_USAU,Is_Ignored_USAU,Team_Rank_Diff_USAU,Game_Rank_Diff_Windmill,Game_Wght_Windmill,Is_Ignored_Windmill,Team_Rank_Diff_Windmill,Game_Rank_Diff_Sigmoid,Game_Wght_Sigmoid,Is_Ignored_Sigmoid,Team_Rank_Diff_Sigmoid
Spring Startup 2024,2024-04-20,Brixton,Chameleons,11,8,365.60925011032475,1.0,0,434.7099999999999,3,1,0,3.7299999999999995,3,1,0,4.164971871033313
Spring Startup 2024,2024-04-20,Brixton,Kestrels,12,6,579.3107485100336,0.9733285267845752,0,-17.25999999999999,6,1,0,-2.0500000000000007,6,1,0,-2.2794563142773594
Spring Startup 2024,2024-04-20,GB U20,Brixton,13,7,557.5316737222639,1.0,0,434.61,6,1,0,6.96,6,1,0,8.002768460158254
Spring Startup 2024,2024-04-20,GB U20,Chameleons,13,2,600.0,1.0,1,869.3199999999999,11,1,0,10.69,11,1,0,10.597792508862128
Spring Startup 2024,2024-04-20,GB U20,Kestrels,11,9,249.2068104043629,1.0,0,417.35,2,1,0,4.909999999999999,2,1,0,6.228271653489923
Spring Startup 2024,2024-04-20,Kestrels,Chameleons,12,6,579.3107485100336,0.9733285267845752,0,451.9699999999999,6,1,0,5.78,6,1,0,6.183514873336133
Windfarm 2024,2024-05-25,Bristol Women,Masterclass,14,10,398.70186369942724,1.0,0,66.09000000000003,4,1,0,0.5800000000000001,4,1,0,0.3509359495085569
Windfarm 2024,2024-05-25,Bristol Women,Spice,14,11,313.3379659704299,1.0,0,323.96000000000004,3,1,0,3.17,3,1,0,3.730828938126166
Windfarm 2024,2024-05-25,Brixton,FRed,9,6,418.5661446562001,0.8885233166386386,0,242.84000000000003,3,1,0,3.0999999999999988,3,1,0,3.7456007390035886
Windfarm 2024,2024-05-25,Chameleons,Eclipse,9,2,600.0,0.8271701918685112,1,719.46,7,1,0,6.74,7,1,0,9.438536689746961
Windfarm 2024,2024-05-25,FRed,Sheffield Steal,13,3,600.0,1.0,0,311.3399999999999,10,1,0,1.08,10,1,0,2.023833469592482
Windfarm 2024,2024-05-25,GB Masters Women,Bristol Women,12,10,238.1225775586291,1.0,0,289.63,2,1,0,2.7200000000000006,2,1,0,2.7966519319611685
Windfarm 2024,2024-05-25,GB Masters Women,Masterclass,13,9,418.5661446562001,1.0,0,355.72,4,1,0,3.3000000000000007,4,1,0,3.133917791937403
Windfarm 2024,2024-05-25,GB Masters Women,Spice,14,10,398.70186369942724,1.0,0,613.59,4,1,0,5.890000000000001,4,1,0,6.238199480652295
Windfarm 2024,2024-05-25,GB U20,Chameleons,13,0,600.0,1.0,1,869.3199999999999,13,1,0,10.69,13,1,0,10.597792508862128
Windfarm 2024,2024-05-25,GB U20,Eclipse,13,1,600.0,1.0,1,1588.78,12,1,0,17.43,12,1,0,13.87012465609866
Windfarm 2024,2024-05-25,GB U20,Kestrels,10,3,600.0,0.8583950752789521,0,417.35,7,1,0,4.909999999999999,7,1,0,6.228271653489923
Windfarm 2024,2024-05-25,GB U20,Newcastle Brown,11,2,600.0,0.9176629354822471,0,591.58,9,1,0,6.85,9,1,0,8.04880320002568
Windfarm 2024,2024-05-25,Horizon,Brixton,15,3,600.0,1.0,0,564.5,12,1,0,10.100000000000001,12,1,0,10.420631493896568
Windfarm 2024,2024-05-25,Horizon,FRed,15,1,600.0,1.0,0,807.34,14,1,0,13.2,14,1,0,12.072051820735041
Windfarm 2024,2024-05-25,Horizon,Sheffield Steal,15,0,600.0,1.0,1,1118.6799999999998,15,1,0,14.28,15,1,0,12.715194710373591
Windfarm 2024,2024-05-25,Itheni,Lemmings,8,7,125.0,0.8885233166386386,0,-231.54999999999995,1,1,0,-2.1000000000000014,1,1,0,-2.129027816736892
Windfarm 2024,2024-05-25,Itheni,SYC,9,7,279.3368557106305,0.9176629354822471,0,197.87,2,1,0,2.929999999999999,2,1,0,2.9022000546316775
Windfarm 2024,2024-05-25,Kestrels,Chameleons,10,7,389.6652919127421,0.9459053029269173,0,451.9699999999999,3,1,0,5.78,3,1,0,6.183514873336133
Windfarm 2024,2024-05-25,Kestrels,Eclipse,13,1,600.0,1.0,1,1171.4299999999998,12,1,0,12.52,12,1,0,12.404433477120815
Windfarm 2024,2024-05-25,Kestrels,Newcastle Brown,9,6,418.5661446562001,0.8885233166386386,0,174.23000000000002,3,1,0,1.9400000000000004,3,1,0,2.3424252820971
Windfarm 2024,2024-05-25,Lemmings,SMOG Women,13,11,228.8403622143806,1.0,0,174.93000000000006,2,1,0,1.1000000000000014,2,1,0,1.1027568177929332
Windfarm 2024,2024-05-25,Lemmings,SYC,15,9,515.4814780292847,1.0,0,429.41999999999996,6,1,0,5.03,6,1,0,4.896755041993799
Windfarm 2024,2024-05-25,Masterclass,Spice,10,9,125.0,1.0,0,257.87,1,1,0,2.59,1,1,0,3.3996758078485456
Windfarm 2024,2024-05-25,Newcastle Brown,Chameleons,12,3,600.0,0.9459053029269173,0,277.7399999999999,9,1,0,3.84,9,1,0,4.105373884823553
Windfarm 2024,2024-05-25,Newcastle Brown,Eclipse,13,2,600.0,1.0,1,997.1999999999999,11,1,0,10.58,11,1,0,11.554102919408447
Windfarm 2024,2024-05-25,SMOG Women,Itheni,12,8,441.15462425988915,1.0,0,56.61999999999989,4,1,0,1.0,4,1,0,1.0370927154564384
Windfarm 2024,2024-05-25,SYC,SMOG Women,9,7,279.3368557106305,0.9176629354822471,0,-254.4899999999999,2,1,0,-3.929999999999999,2,1,0,-3.887292023517201
Windfarm 2024,2024-05-25,Sheffield Steal,Brixton,7,6,125.0,0.8271701918685112,0,-554.18,1,1,0,-4.179999999999999,1,1,0,-5.581391614668684
Windfarm 2024,2024-05-26,Brixton,Chameleons,8,4,564.8086448756737,0.7947194142390263,0,434.7099999999999,4,1,0,3.7299999999999995,4,1,0,4.164971871033313
Windfarm 2024,2024-05-26,Brixton,Eclipse,13,4,600.0,1.0,1,1154.17,9,1,0,10.469999999999999,9,1,0,11.580246940313241
Windfarm 2024,2024-05-26,Chameleons,Sheffield Steal,11,6,546.6949863040446,0.9459053029269173,0,119.47000000000003,5,1,0,0.4499999999999993,5,1,0,1.5796216081477183
Windfarm 2024,2024-05-26,GB Masters Women,Bristol Women,12,7,520.5112660164395,1.0,0,289.63,5,1,0,2.7200000000000006,5,1,0,2.7966519319611685
Windfarm 2024,2024-05-26,GB U20,FRed,15,3,600.0,1.0,1,677.45,12,1,0,10.059999999999999,12,1,0,10.36721737737265
Windfarm 2024,2024-05-26,Horizon,GB U20,11,9,249.2068104043629,1.0,0,129.89000000000001,2,1,0,3.14,2,1,0,3.8417779081653833
Windfarm 2024,2024-05-26,Horizon,Kestrels,15,6,600.0,1.0,0,547.24,9,1,0,8.05,9,1,0,9.102087593549474
Windfarm 2024,2024-05-26,Itheni,Bristol Women,14,9,473.8676990361691,1.0,0,331.28999999999996,5,1,0,3.2799999999999994,5,1,0,3.3127568877059055
Windfarm 2024,2024-05-26,Kestrels,FRed,15,1,600.0,1.0,0,260.1,14,1,0,5.1499999999999995,14,1,0,5.80478647769117
Windfarm 2024,2024-05-26,Lemmings,GB Masters Women,15,12,300.4922431832018,1.0,0,273.2099999999999,3,1,0,2.66,3,1,0,2.6537801350920383
Windfarm 2024,2024-05-26,Lemmings,Itheni,10,7,389.6652919127421,0.9459053029269173,0,231.54999999999995,3,1,0,2.1000000000000014,3,1,0,2.129027816736894
Windfarm 2024,2024-05-26,Masterclass,FRed,15,1,600.0,1.0,1,1506.08,14,1,0,16.549999999999997,14,1,0,13.800283555328484
Windfarm 2024,2024-05-26,Masterclass,Spice,14,6,600.0,1.0,0,257.87,8,1,0,2.59,8,1,0,3.3996758078485456
Windfarm 2024,2024-05-26,Newcastle Brown,Brixton,1,1,0.0,0.3244428422615251,0,-156.97000000000003,0,1,0,0.11000000000000032,0,1,0,-0.06449960246794184
Windfarm 2024,2024-05-26,Newcastle Brown,Sheffield Steal,10,8,262.66557693448596,0.9733285267845752,0,397.2099999999999,2,1,0,4.289999999999999,2,1,0,5.525733124794673
Windfarm 2024,2024-05-26,SMOG Women,GB U20,15,3,600.0,1.0,1,1282.6299999999999,12,1,0,11.35,12,1,0,11.763076923481403
Windfarm 2024,2024-05-26,SMOG Women,Masterclass,10,8,262.66557693448596,0.9733285267845752,0,453.9999999999999,2,1,0,4.859999999999999,2,1,0,4.604594348217361
Windfarm 2024,2024-05-26,SMOG Women,SYC,14,4,600.0,1.0,0,254.4899999999999,10,1,0,3.929999999999999,10,1,0,3.887292023517201
Windfarm 2024,2024-05-26,SYC,Kestrels,15,4,600.0,1.0,1,1445.49,11,1,0,12.33,11,1,0,12.651276707427982
Windfarm 2024,2024-05-26,SYC,Spice,14,9,473.8676990361691,1.0,0,457.38,5,1,0,3.5200000000000005,5,1,0,4.13033906752397
Windfarm 2024,2024-05-26,Sheffield Steal,Eclipse,15,2,600.0,1.0,0,599.99,13,1,0,6.290000000000001,13,1,0,8.416631637056987
Windfarm 2024,2024-05-26,Spice,Horizon,12,8,441.15462425988915,1.0,0,440.87,4,1,0,0.7599999999999998,4,1,0,3.622974558232489
